대여대여소번호,반납대여소번호,대여,반납,총대여,총반납,차이,총차이,ScoreMag,ScoreRatio,lent_stationName,return_stationName,url
2306,2347,6,290,5624,4871,-284,753,5,0.959459459,압구정역 2번 출구 옆,두산건설 본사,http://map.daum.net/?sName=압구정역 2번 출구 옆 대여소&eName=두산건설 본사 대여소&target=bicycle
2306,2352,47,157,5624,4871,-110,753,2,0.539215686,압구정역 2번 출구 옆,서울본부세관(건설회관 앞),http://map.daum.net/?sName=압구정역 2번 출구 옆 대여소&eName=서울본부세관(건설회관 앞) 대여소&target=bicycle
2306,2308,701,386,5624,4871,315,753,6,0.289788408,압구정역 2번 출구 옆,압구정파출소 앞,http://map.daum.net/?sName=압구정역 2번 출구 옆 대여소&eName=압구정파출소 앞 대여소&target=bicycle
131,167,14,294,7427,8415,-280,-988,5,0.909090909,증산2교,연가초등학교 옆,http://map.daum.net/?sName=증산2교 대여소&eName=연가초등학교 옆 대여소&target=bicycle
113,167,22,206,32779,40103,-184,-7324,3,0.807017544,홍대입구역 2번출구 앞,연가초등학교 옆,http://map.daum.net/?sName=홍대입구역 2번출구 앞 대여소&eName=연가초등학교 옆 대여소&target=bicycle
131,414,167,57,7427,8415,110,-988,2,0.491071429,증산2교,상암동주민센터 옆,http://map.daum.net/?sName=증산2교 대여소&eName=상암동주민센터 옆 대여소&target=bicycle
400,414,335,221,4593,5026,114,-433,2,0.205035971,상암한화오벨리스크 1차 앞,상암동주민센터 옆,http://map.daum.net/?sName=상암한화오벨리스크 1차 앞 대여소&eName=상암동주민센터 옆 대여소&target=bicycle
409,414,194,387,11080,13610,-193,-2530,3,0.332185886,누리꿈스퀘어 옆,상암동주민센터 옆,http://map.daum.net/?sName=누리꿈스퀘어 옆 대여소&eName=상암동주민센터 옆 대여소&target=bicycle
131,133,238,129,7427,8415,109,-988,2,0.297002725,증산2교,해담는다리,http://map.daum.net/?sName=증산2교 대여소&eName=해담는다리 대여소&target=bicycle
131,415,82,150,7427,8415,-68,-988,1,0.293103448,증산2교,DMC역 9번출구 앞,http://map.daum.net/?sName=증산2교 대여소&eName=DMC역 9번출구 앞 대여소&target=bicycle
409,415,1115,1795,11080,13610,-680,-2530,13,0.233676976,누리꿈스퀘어 옆,DMC역 9번출구 앞,http://map.daum.net/?sName=누리꿈스퀘어 옆 대여소&eName=DMC역 9번출구 앞 대여소&target=bicycle
178,415,215,131,3419,3650,84,-231,1,0.242774566,증산3교 앞,DMC역 9번출구 앞,http://map.daum.net/?sName=증산3교 앞 대여소&eName=DMC역 9번출구 앞 대여소&target=bicycle
203,213,30,479,7670,7620,-449,50,8,0.882121807,국회의사당역 3번출구 옆,KT앞,http://map.daum.net/?sName=국회의사당역 3번출구 옆 대여소&eName=KT앞 대여소&target=bicycle
204,213,27,312,5442,5216,-285,226,5,0.840707965,국회의사당역 5번출구 옆,KT앞,http://map.daum.net/?sName=국회의사당역 5번출구 옆 대여소&eName=KT앞 대여소&target=bicycle
206,213,206,355,8174,7845,-149,329,2,0.265597148,KBS 앞,KT앞,http://map.daum.net/?sName=KBS 앞 대여소&eName=KT앞 대여소&target=bicycle
207,213,67,133,48130,45467,-66,2663,1,0.33,여의나루역 1번출구 앞,KT앞,http://map.daum.net/?sName=여의나루역 1번출구 앞 대여소&eName=KT앞 대여소&target=bicycle
205,213,76,158,7337,7031,-82,306,1,0.35042735,산업은행 앞,KT앞,http://map.daum.net/?sName=산업은행 앞 대여소&eName=KT앞 대여소&target=bicycle
202,213,64,157,13050,14170,-93,-1120,1,0.42081448,국민일보 앞,KT앞,http://map.daum.net/?sName=국민일보 앞 대여소&eName=KT앞 대여소&target=bicycle
210,213,491,748,20427,20741,-257,-314,5,0.207425343,IFC몰,KT앞,http://map.daum.net/?sName=IFC몰 대여소&eName=KT앞 대여소&target=bicycle
203,212,88,304,7670,7620,-216,50,4,0.551020408,국회의사당역 3번출구 옆,여의도역 1번출구 옆,http://map.daum.net/?sName=국회의사당역 3번출구 옆 대여소&eName=여의도역 1번출구 옆 대여소&target=bicycle
204,212,72,259,5442,5216,-187,226,3,0.564954683,국회의사당역 5번출구 옆,여의도역 1번출구 옆,http://map.daum.net/?sName=국회의사당역 5번출구 옆 대여소&eName=여의도역 1번출구 옆 대여소&target=bicycle
206,212,153,438,8174,7845,-285,329,5,0.482233503,KBS 앞,여의도역 1번출구 옆,http://map.daum.net/?sName=KBS 앞 대여소&eName=여의도역 1번출구 옆 대여소&target=bicycle
207,212,158,526,48130,45467,-368,2663,7,0.538011696,여의나루역 1번출구 앞,여의도역 1번출구 옆,http://map.daum.net/?sName=여의나루역 1번출구 앞 대여소&eName=여의도역 1번출구 옆 대여소&target=bicycle
211,212,93,246,12700,11273,-153,1427,3,0.451327434,여의도역 4번출구 옆,여의도역 1번출구 옆,http://map.daum.net/?sName=여의도역 4번출구 옆 대여소&eName=여의도역 1번출구 옆 대여소&target=bicycle
205,212,62,185,7337,7031,-123,306,2,0.497975709,산업은행 앞,여의도역 1번출구 옆,http://map.daum.net/?sName=산업은행 앞 대여소&eName=여의도역 1번출구 옆 대여소&target=bicycle
202,212,157,324,13050,14170,-167,-1120,3,0.347193347,국민일보 앞,여의도역 1번출구 옆,http://map.daum.net/?sName=국민일보 앞 대여소&eName=여의도역 1번출구 옆 대여소&target=bicycle
210,212,203,327,20427,20741,-124,-314,2,0.233962264,IFC몰,여의도역 1번출구 옆,http://map.daum.net/?sName=IFC몰 대여소&eName=여의도역 1번출구 옆 대여소&target=bicycle
203,258,56,145,7670,7620,-89,50,1,0.44278607,국회의사당역 3번출구 옆,신길역3번출구,http://map.daum.net/?sName=국회의사당역 3번출구 옆 대여소&eName=신길역3번출구 대여소&target=bicycle
212,258,231,53,13214,5886,178,7328,3,0.626760563,여의도역 1번출구 옆,신길역3번출구,http://map.daum.net/?sName=여의도역 1번출구 옆 대여소&eName=신길역3번출구 대여소&target=bicycle
205,258,87,169,7337,7031,-82,306,1,0.3203125,산업은행 앞,신길역3번출구,http://map.daum.net/?sName=산업은행 앞 대여소&eName=신길역3번출구 대여소&target=bicycle
200,258,63,179,3254,2878,-116,376,2,0.479338843,국회의원회관,신길역3번출구,http://map.daum.net/?sName=국회의원회관 대여소&eName=신길역3번출구 대여소&target=bicycle
210,258,379,790,20427,20741,-411,-314,8,0.351582549,IFC몰,신길역3번출구,http://map.daum.net/?sName=IFC몰 대여소&eName=신길역3번출구 대여소&target=bicycle
257,258,103,171,8039,11421,-68,-3382,1,0.248175182,신길삼거리(우리은행),신길역3번출구,http://map.daum.net/?sName=신길삼거리(우리은행) 대여소&eName=신길역3번출구 대여소&target=bicycle
203,214,144,309,7670,7620,-165,50,3,0.364238411,국회의사당역 3번출구 옆,금융감독원 앞,http://map.daum.net/?sName=국회의사당역 3번출구 옆 대여소&eName=금융감독원 앞 대여소&target=bicycle
212,214,151,100,13214,5886,51,7328,1,0.203187251,여의도역 1번출구 옆,금융감독원 앞,http://map.daum.net/?sName=여의도역 1번출구 옆 대여소&eName=금융감독원 앞 대여소&target=bicycle
207,214,75,179,48130,45467,-104,2663,2,0.409448819,여의나루역 1번출구 앞,금융감독원 앞,http://map.daum.net/?sName=여의나루역 1번출구 앞 대여소&eName=금융감독원 앞 대여소&target=bicycle
204,274,169,52,5442,5216,117,226,2,0.529411765,국회의사당역 5번출구 옆,영등포역지하쇼핑센타 5번출구,http://map.daum.net/?sName=국회의사당역 5번출구 옆 대여소&eName=영등포역지하쇼핑센타 5번출구 대여소&target=bicycle
212,274,251,69,13214,5886,182,7328,3,0.56875,여의도역 1번출구 옆,영등포역지하쇼핑센타 5번출구,http://map.daum.net/?sName=여의도역 1번출구 옆 대여소&eName=영등포역지하쇼핑센타 5번출구 대여소&target=bicycle
206,274,363,167,8174,7845,196,329,3,0.369811321,KBS 앞,영등포역지하쇼핑센타 5번출구,http://map.daum.net/?sName=KBS 앞 대여소&eName=영등포역지하쇼핑센타 5번출구 대여소&target=bicycle
214,274,366,96,5718,4078,270,1640,5,0.584415584,금융감독원 앞,영등포역지하쇼핑센타 5번출구,http://map.daum.net/?sName=금융감독원 앞 대여소&eName=영등포역지하쇼핑센타 5번출구 대여소&target=bicycle
213,274,480,148,8227,6685,332,1542,6,0.52866242,KT앞,영등포역지하쇼핑센타 5번출구,http://map.daum.net/?sName=KT앞 대여소&eName=영등포역지하쇼핑센타 5번출구 대여소&target=bicycle
211,274,205,68,12700,11273,137,1427,2,0.501831502,여의도역 4번출구 옆,영등포역지하쇼핑센타 5번출구,http://map.daum.net/?sName=여의도역 4번출구 옆 대여소&eName=영등포역지하쇼핑센타 5번출구 대여소&target=bicycle
205,274,254,96,7337,7031,158,306,3,0.451428571,산업은행 앞,영등포역지하쇼핑센타 5번출구,http://map.daum.net/?sName=산업은행 앞 대여소&eName=영등포역지하쇼핑센타 5번출구 대여소&target=bicycle
1925,274,85,145,10853,11258,-60,-405,1,0.260869565,동양미래대학교 정문 옆,영등포역지하쇼핑센타 5번출구,http://map.daum.net/?sName=동양미래대학교 정문 옆 대여소&eName=영등포역지하쇼핑센타 5번출구 대여소&target=bicycle
202,274,283,157,13050,14170,126,-1120,2,0.286363636,국민일보 앞,영등포역지하쇼핑센타 5번출구,http://map.daum.net/?sName=국민일보 앞 대여소&eName=영등포역지하쇼핑센타 5번출구 대여소&target=bicycle
238,274,141,69,8430,8601,72,-171,1,0.342857143,제2구민체육센타 앞,영등포역지하쇼핑센타 5번출구,http://map.daum.net/?sName=제2구민체육센타 앞 대여소&eName=영등포역지하쇼핑센타 5번출구 대여소&target=bicycle
210,274,524,300,20427,20741,224,-314,4,0.27184466,IFC몰,영등포역지하쇼핑센타 5번출구,http://map.daum.net/?sName=IFC몰 대여소&eName=영등포역지하쇼핑센타 5번출구 대여소&target=bicycle
257,274,315,539,8039,11421,-224,-3382,4,0.262295082,신길삼거리(우리은행),영등포역지하쇼핑센타 5번출구,http://map.daum.net/?sName=신길삼거리(우리은행) 대여소&eName=영등포역지하쇼핑센타 5번출구 대여소&target=bicycle
240,274,243,154,7187,6598,89,589,1,0.22418136,문래역 4번출구 앞,영등포역지하쇼핑센타 5번출구,http://map.daum.net/?sName=문래역 4번출구 앞 대여소&eName=영등포역지하쇼핑센타 5번출구 대여소&target=bicycle
204,247,190,102,5442,5216,88,226,1,0.301369863,국회의사당역 5번출구 옆,당산역 10번출구 앞,http://map.daum.net/?sName=국회의사당역 5번출구 옆 대여소&eName=당산역 10번출구 앞 대여소&target=bicycle
227,247,190,310,6651,8339,-120,-1688,2,0.24,양평2나들목 보행통로 입구,당산역 10번출구 앞,http://map.daum.net/?sName=양평2나들목 보행통로 입구 대여소&eName=당산역 10번출구 앞 대여소&target=bicycle
204,239,86,144,5442,5216,-58,226,1,0.252173913,국회의사당역 5번출구 옆,유스호스텔 앞,http://map.daum.net/?sName=국회의사당역 5번출구 옆 대여소&eName=유스호스텔 앞 대여소&target=bicycle
213,239,57,181,8227,6685,-124,1542,2,0.521008403,KT앞,유스호스텔 앞,http://map.daum.net/?sName=KT앞 대여소&eName=유스호스텔 앞 대여소&target=bicycle
113,3101,57,202,32779,40103,-145,-7324,2,0.55984556,홍대입구역 2번출구 앞,서대문구청,http://map.daum.net/?sName=홍대입구역 2번출구 앞 대여소&eName=서대문구청 대여소&target=bicycle
166,3101,86,190,8122,8785,-104,-663,2,0.376811594,가재울 초등학교,서대문구청,http://map.daum.net/?sName=가재울 초등학교 대여소&eName=서대문구청 대여소&target=bicycle
188,3101,81,132,4860,5122,-51,-262,1,0.23943662,홍은동 정원여중 입구,서대문구청,http://map.daum.net/?sName=홍은동 정원여중 입구 대여소&eName=서대문구청 대여소&target=bicycle
113,196,160,508,32779,40103,-348,-7324,6,0.520958084,홍대입구역 2번출구 앞,연희교차로 인근,http://map.daum.net/?sName=홍대입구역 2번출구 앞 대여소&eName=연희교차로 인근 대여소&target=bicycle
113,172,194,581,32779,40103,-387,-7324,7,0.499354839,홍대입구역 2번출구 앞,서대문소방서,http://map.daum.net/?sName=홍대입구역 2번출구 앞 대여소&eName=서대문소방서 대여소&target=bicycle
128,172,82,136,9612,9498,-54,114,1,0.247706422,신촌역(2호선) 1번출구 옆,서대문소방서,http://map.daum.net/?sName=신촌역(2호선) 1번출구 옆 대여소&eName=서대문소방서 대여소&target=bicycle
115,172,157,98,8254,7077,59,1177,1,0.231372549,사루비아 빌딩 앞,서대문소방서,http://map.daum.net/?sName=사루비아 빌딩 앞 대여소&eName=서대문소방서 대여소&target=bicycle
113,188,138,387,32779,40103,-249,-7324,4,0.474285714,홍대입구역 2번출구 앞,홍은동 정원여중 입구,http://map.daum.net/?sName=홍대입구역 2번출구 앞 대여소&eName=홍은동 정원여중 입구 대여소&target=bicycle
113,168,144,344,32779,40103,-200,-7324,4,0.409836066,홍대입구역 2번출구 앞,남가좌동 사거리,http://map.daum.net/?sName=홍대입구역 2번출구 앞 대여소&eName=남가좌동 사거리 대여소&target=bicycle
113,165,289,638,32779,40103,-349,-7324,6,0.376483279,홍대입구역 2번출구 앞,중앙근린공원,http://map.daum.net/?sName=홍대입구역 2번출구 앞 대여소&eName=중앙근린공원 대여소&target=bicycle
113,141,85,169,32779,40103,-84,-7324,1,0.330708661,홍대입구역 2번출구 앞,연대 대운동장 옆,http://map.daum.net/?sName=홍대입구역 2번출구 앞 대여소&eName=연대 대운동장 옆 대여소&target=bicycle
128,141,426,721,9612,9498,-295,114,5,0.257192677,신촌역(2호선) 1번출구 옆,연대 대운동장 옆,http://map.daum.net/?sName=신촌역(2호선) 1번출구 옆 대여소&eName=연대 대운동장 옆 대여소&target=bicycle
132,141,110,246,6680,6284,-136,396,2,0.382022472,창천문화공원,연대 대운동장 옆,http://map.daum.net/?sName=창천문화공원 대여소&eName=연대 대운동장 옆 대여소&target=bicycle
113,130,268,136,32779,40103,132,-7324,2,0.326732673,홍대입구역 2번출구 앞,신촌역(2호선) 7번출구 앞,http://map.daum.net/?sName=홍대입구역 2번출구 앞 대여소&eName=신촌역(2호선) 7번출구 앞 대여소&target=bicycle
107,130,141,68,12206,14037,73,-1831,1,0.349282297,신한은행 서교동금융센터점 앞,신촌역(2호선) 7번출구 앞,http://map.daum.net/?sName=신한은행 서교동금융센터점 앞 대여소&eName=신촌역(2호선) 7번출구 앞 대여소&target=bicycle
120,130,125,215,3107,3243,-90,-136,1,0.264705882,신수동 사거리,신촌역(2호선) 7번출구 앞,http://map.daum.net/?sName=신수동 사거리 대여소&eName=신촌역(2호선) 7번출구 앞 대여소&target=bicycle
122,130,209,332,6438,6702,-123,-264,2,0.227356747,신성기사식당 앞,신촌역(2호선) 7번출구 앞,http://map.daum.net/?sName=신성기사식당 앞 대여소&eName=신촌역(2호선) 7번출구 앞 대여소&target=bicycle
113,169,102,197,32779,40103,-95,-7324,1,0.317725753,홍대입구역 2번출구 앞,북가좌 삼거리,http://map.daum.net/?sName=홍대입구역 2번출구 앞 대여소&eName=북가좌 삼거리 대여소&target=bicycle
113,174,105,202,32779,40103,-97,-7324,1,0.315960912,홍대입구역 2번출구 앞,명지대학교 학생회관,http://map.daum.net/?sName=홍대입구역 2번출구 앞 대여소&eName=명지대학교 학생회관 대여소&target=bicycle
113,207,164,88,32779,40103,76,-7324,1,0.301587302,홍대입구역 2번출구 앞,여의나루역 1번출구 앞,http://map.daum.net/?sName=홍대입구역 2번출구 앞 대여소&eName=여의나루역 1번출구 앞 대여소&target=bicycle
147,207,337,544,9441,11290,-207,-1849,4,0.234960272,마포역 4번출구 뒤,여의나루역 1번출구 앞,http://map.daum.net/?sName=마포역 4번출구 뒤 대여소&eName=여의나루역 1번출구 앞 대여소&target=bicycle
205,207,253,155,7337,7031,98,306,1,0.240196078,산업은행 앞,여의나루역 1번출구 앞,http://map.daum.net/?sName=산업은행 앞 대여소&eName=여의나루역 1번출구 앞 대여소&target=bicycle
146,207,316,210,10914,11574,106,-660,2,0.201520913,마포역 1번출구 뒤,여의나루역 1번출구 앞,http://map.daum.net/?sName=마포역 1번출구 뒤 대여소&eName=여의나루역 1번출구 앞 대여소&target=bicycle
202,207,818,1606,13050,14170,-788,-1120,15,0.325082508,국민일보 앞,여의나루역 1번출구 앞,http://map.daum.net/?sName=국민일보 앞 대여소&eName=여의나루역 1번출구 앞 대여소&target=bicycle
106,207,203,357,17613,16584,-154,1029,3,0.275,합정역 7번출구 앞,여의나루역 1번출구 앞,http://map.daum.net/?sName=합정역 7번출구 앞 대여소&eName=여의나루역 1번출구 앞 대여소&target=bicycle
130,207,82,147,8994,8893,-65,101,1,0.283842795,신촌역(2호선) 7번출구 앞,여의나루역 1번출구 앞,http://map.daum.net/?sName=신촌역(2호선) 7번출구 앞 대여소&eName=여의나루역 1번출구 앞 대여소&target=bicycle
144,207,340,519,14007,15077,-179,-1070,3,0.208381839,공덕역 8번출구,여의나루역 1번출구 앞,http://map.daum.net/?sName=공덕역 8번출구 대여소&eName=여의나루역 1번출구 앞 대여소&target=bicycle
113,164,187,344,32779,40103,-157,-7324,3,0.29566855,홍대입구역 2번출구 앞,북가좌1동 주민센터,http://map.daum.net/?sName=홍대입구역 2번출구 앞 대여소&eName=북가좌1동 주민센터 대여소&target=bicycle
113,179,407,712,32779,40103,-305,-7324,6,0.27256479,홍대입구역 2번출구 앞,가좌역 4번출구 앞,http://map.daum.net/?sName=홍대입구역 2번출구 앞 대여소&eName=가좌역 4번출구 앞 대여소&target=bicycle
166,179,867,577,8122,8785,290,-663,5,0.200831025,가재울 초등학교,가좌역 4번출구 앞,http://map.daum.net/?sName=가재울 초등학교 대여소&eName=가좌역 4번출구 앞 대여소&target=bicycle
116,179,73,151,9467,10180,-78,-713,1,0.348214286,일진아이윌아파트 옆,가좌역 4번출구 앞,http://map.daum.net/?sName=일진아이윌아파트 옆 대여소&eName=가좌역 4번출구 앞 대여소&target=bicycle
153,179,136,206,11604,12172,-70,-568,1,0.204678363,성산2교 사거리,가좌역 4번출구 앞,http://map.daum.net/?sName=성산2교 사거리 대여소&eName=가좌역 4번출구 앞 대여소&target=bicycle
168,179,164,101,2274,1469,63,805,1,0.237735849,남가좌동 사거리,가좌역 4번출구 앞,http://map.daum.net/?sName=남가좌동 사거리 대여소&eName=가좌역 4번출구 앞 대여소&target=bicycle
113,138,77,133,32779,40103,-56,-7324,1,0.266666667,홍대입구역 2번출구 앞,신촌동 제1공영주차장 앞,http://map.daum.net/?sName=홍대입구역 2번출구 앞 대여소&eName=신촌동 제1공영주차장 앞 대여소&target=bicycle
113,3102,1026,1686,32779,40103,-660,-7324,13,0.243362832,홍대입구역 2번출구 앞,연희삼거리,http://map.daum.net/?sName=홍대입구역 2번출구 앞 대여소&eName=연희삼거리 대여소&target=bicycle
114,3102,332,182,13563,13818,150,-255,3,0.291828794,홍대입구역 8번출구 앞,연희삼거리,http://map.daum.net/?sName=홍대입구역 8번출구 앞 대여소&eName=연희삼거리 대여소&target=bicycle
138,3102,201,72,4932,4737,129,195,2,0.472527473,신촌동 제1공영주차장 앞,연희삼거리,http://map.daum.net/?sName=신촌동 제1공영주차장 앞 대여소&eName=연희삼거리 대여소&target=bicycle
115,3102,345,205,8254,7077,140,1177,2,0.254545455,사루비아 빌딩 앞,연희삼거리,http://map.daum.net/?sName=사루비아 빌딩 앞 대여소&eName=연희삼거리 대여소&target=bicycle
107,3102,137,248,12206,14037,-111,-1831,2,0.288311688,신한은행 서교동금융센터점 앞,연희삼거리,http://map.daum.net/?sName=신한은행 서교동금융센터점 앞 대여소&eName=연희삼거리 대여소&target=bicycle
153,3102,140,72,11604,12172,68,-568,1,0.320754717,성산2교 사거리,연희삼거리,http://map.daum.net/?sName=성산2교 사거리 대여소&eName=연희삼거리 대여소&target=bicycle
3101,3102,209,108,3837,3295,101,542,2,0.318611987,서대문구청,연희삼거리,http://map.daum.net/?sName=서대문구청 대여소&eName=연희삼거리 대여소&target=bicycle
108,3102,81,150,8583,8757,-69,-174,1,0.298701299,서교동 사거리,연희삼거리,http://map.daum.net/?sName=서교동 사거리 대여소&eName=연희삼거리 대여소&target=bicycle
113,163,123,198,32779,40103,-75,-7324,1,0.23364486,홍대입구역 2번출구 앞,명지전문대학교 정문 앞,http://map.daum.net/?sName=홍대입구역 2번출구 앞 대여소&eName=명지전문대학교 정문 앞 대여소&target=bicycle
117,163,120,201,10247,10327,-81,-80,1,0.252336449,홍은사거리,명지전문대학교 정문 앞,http://map.daum.net/?sName=홍은사거리 대여소&eName=명지전문대학교 정문 앞 대여소&target=bicycle
113,153,1119,1752,32779,40103,-633,-7324,12,0.220480669,홍대입구역 2번출구 앞,성산2교 사거리,http://map.daum.net/?sName=홍대입구역 2번출구 앞 대여소&eName=성산2교 사거리 대여소&target=bicycle
103,153,149,84,10248,9142,65,1106,1,0.278969957,망원역 2번출구 앞,성산2교 사거리,http://map.daum.net/?sName=망원역 2번출구 앞 대여소&eName=성산2교 사거리 대여소&target=bicycle
113,175,450,691,32779,40103,-241,-7324,4,0.21121823,홍대입구역 2번출구 앞,홍연2교옆,http://map.daum.net/?sName=홍대입구역 2번출구 앞 대여소&eName=홍연2교옆 대여소&target=bicycle
163,175,134,76,2789,2320,58,469,1,0.276190476,명지전문대학교 정문 앞,홍연2교옆,http://map.daum.net/?sName=명지전문대학교 정문 앞 대여소&eName=홍연2교옆 대여소&target=bicycle
818,831,22,178,5921,6563,-156,-642,3,0.78,숙명여대 입구 교차로,이태원관광특구입구,http://map.daum.net/?sName=숙명여대 입구 교차로 대여소&eName=이태원관광특구입구 대여소&target=bicycle
805,831,55,149,4517,5252,-94,-735,1,0.460784314,문배어린이공원 앞,이태원관광특구입구,http://map.daum.net/?sName=문배어린이공원 앞 대여소&eName=이태원관광특구입구 대여소&target=bicycle
816,831,252,469,16000,16420,-217,-420,4,0.300970874,신용산역 6번출구 앞,이태원관광특구입구,http://map.daum.net/?sName=신용산역 6번출구 앞 대여소&eName=이태원관광특구입구 대여소&target=bicycle
825,831,106,195,10512,12350,-89,-1838,1,0.295681063,서빙고동 주민센터 앞,이태원관광특구입구,http://map.daum.net/?sName=서빙고동 주민센터 앞 대여소&eName=이태원관광특구입구 대여소&target=bicycle
812,831,123,213,2600,2209,-90,391,1,0.267857143,용산전쟁기념관,이태원관광특구입구,http://map.daum.net/?sName=용산전쟁기념관 대여소&eName=이태원관광특구입구 대여소&target=bicycle
818,835,130,300,5921,6563,-170,-642,3,0.395348837,숙명여대 입구 교차로,남영역 건너편,http://map.daum.net/?sName=숙명여대 입구 교차로 대여소&eName=남영역 건너편 대여소&target=bicycle
834,835,70,148,5855,6824,-78,-969,1,0.357798165,효창공원앞역 3번출구 뒤,남영역 건너편,http://map.daum.net/?sName=효창공원앞역 3번출구 뒤 대여소&eName=남영역 건너편 대여소&target=bicycle
312,451,27,217,9192,8974,-190,218,3,0.778688525,시청역 1번출구 뒤,청와대앞길,http://map.daum.net/?sName=시청역 1번출구 뒤 대여소&eName=청와대앞길 대여소&target=bicycle
312,394,67,169,9192,8974,-102,218,2,0.43220339,시청역 1번출구 뒤,경희궁 자이 3단지,http://map.daum.net/?sName=시청역 1번출구 뒤 대여소&eName=경희궁 자이 3단지 대여소&target=bicycle
367,394,83,135,3172,3080,-52,92,1,0.23853211,독립문역 3-1번출구,경희궁 자이 3단지,http://map.daum.net/?sName=독립문역 3-1번출구 대여소&eName=경희궁 자이 3단지 대여소&target=bicycle
312,391,384,204,9192,8974,180,218,3,0.306122449,시청역 1번출구 뒤,정동길입구,http://map.daum.net/?sName=시청역 1번출구 뒤 대여소&eName=정동길입구 대여소&target=bicycle
309,391,65,141,5992,4473,-76,1519,1,0.368932039,광화문역 6번출구 옆,정동길입구,http://map.daum.net/?sName=광화문역 6번출구 옆 대여소&eName=정동길입구 대여소&target=bicycle
312,369,116,202,9192,8974,-86,218,1,0.270440252,시청역 1번출구 뒤,광화문 시민열린마당,http://map.daum.net/?sName=시청역 1번출구 뒤 대여소&eName=광화문 시민열린마당 대여소&target=bicycle
305,369,119,238,7458,7793,-119,-335,2,0.333333333,종로구청 옆,광화문 시민열린마당,http://map.daum.net/?sName=종로구청 옆 대여소&eName=광화문 시민열린마당 대여소&target=bicycle
327,369,62,167,7393,6943,-105,450,2,0.458515284,낙원상가 옆,광화문 시민열린마당,http://map.daum.net/?sName=낙원상가 옆 대여소&eName=광화문 시민열린마당 대여소&target=bicycle
314,369,103,260,7832,7432,-157,400,3,0.432506887,국립현대미술관,광화문 시민열린마당,http://map.daum.net/?sName=국립현대미술관 대여소&eName=광화문 시민열린마당 대여소&target=bicycle
311,369,433,249,12978,9711,184,3267,3,0.269794721,서울광장 옆,광화문 시민열린마당,http://map.daum.net/?sName=서울광장 옆 대여소&eName=광화문 시민열린마당 대여소&target=bicycle
315,369,92,170,4894,4709,-78,185,1,0.297709924,신한은행 안국역지점 옆,광화문 시민열린마당,http://map.daum.net/?sName=신한은행 안국역지점 옆 대여소&eName=광화문 시민열린마당 대여소&target=bicycle
306,369,168,95,6507,5357,73,1150,1,0.27756654,광화문역 7번출구 앞,광화문 시민열린마당,http://map.daum.net/?sName=광화문역 7번출구 앞 대여소&eName=광화문 시민열린마당 대여소&target=bicycle
2050,2057,51,359,12783,16028,-308,-3245,6,0.751219512,노량진역 5번출구,상도 아이파크 아파트,http://map.daum.net/?sName=노량진역 5번출구 대여소&eName=상도 아이파크 아파트 대여소&target=bicycle
2020,2057,65,205,3006,2470,-140,536,2,0.518518519,장승배기역2번출구뒷편쪽,상도 아이파크 아파트,http://map.daum.net/?sName=장승배기역2번출구뒷편쪽 대여소&eName=상도 아이파크 아파트 대여소&target=bicycle
2015,2057,73,131,6949,8246,-58,-1297,1,0.284313725,신대방삼거리역 6번출구쪽,상도 아이파크 아파트,http://map.daum.net/?sName=신대방삼거리역 6번출구쪽 대여소&eName=상도 아이파크 아파트 대여소&target=bicycle
2050,829,83,166,12783,16028,-83,-3245,1,0.333333333,노량진역 5번출구,베르가모앞,http://map.daum.net/?sName=노량진역 5번출구 대여소&eName=베르가모앞 대여소&target=bicycle
2058,829,118,248,10382,10857,-130,-475,2,0.355191257,노량진동 맥도널드앞,베르가모앞,http://map.daum.net/?sName=노량진동 맥도널드앞 대여소&eName=베르가모앞 대여소&target=bicycle
816,829,687,454,16000,16420,233,-420,4,0.204206836,신용산역 6번출구 앞,베르가모앞,http://map.daum.net/?sName=신용산역 6번출구 앞 대여소&eName=베르가모앞 대여소&target=bicycle
2050,2054,286,437,12783,16028,-151,-3245,3,0.208852006,노량진역 5번출구,삼익아파트,http://map.daum.net/?sName=노량진역 5번출구 대여소&eName=삼익아파트 대여소&target=bicycle
2003,2054,82,153,7661,7766,-71,-105,1,0.30212766,사육신공원앞,삼익아파트,http://map.daum.net/?sName=사육신공원앞 대여소&eName=삼익아파트 대여소&target=bicycle
129,136,45,304,6810,6674,-259,136,5,0.742120344,신촌역(2호선) 6번출구 옆,대흥동 주민센터,http://map.daum.net/?sName=신촌역(2호선) 6번출구 옆 대여소&eName=대흥동 주민센터 대여소&target=bicycle
126,136,143,252,10989,11438,-109,-449,2,0.275949367,서강대 후문 옆,대흥동 주민센터,http://map.daum.net/?sName=서강대 후문 옆 대여소&eName=대흥동 주민센터 대여소&target=bicycle
2221,2235,60,369,4065,4561,-309,-496,6,0.72027972,하나은행 방배동지점 앞,KT 서초지사 앞,http://map.daum.net/?sName=하나은행 방배동지점 앞 대여소&eName=KT 서초지사 앞 대여소&target=bicycle
594,646,49,301,1993,2398,-252,-405,5,0.72,중랑물재생센터(서울새활용플라자),장한평역 1번출구 (국민은행앞),http://map.daum.net/?sName=중랑물재생센터(서울새활용플라자) 대여소&eName=장한평역 1번출구 (국민은행앞) 대여소&target=bicycle
526,646,134,287,4830,5236,-153,-406,3,0.363420428,용답토속공원 앞,장한평역 1번출구 (국민은행앞),http://map.daum.net/?sName=용답토속공원 앞 대여소&eName=장한평역 1번출구 (국민은행앞) 대여소&target=bicycle
128,162,191,1126,9612,9498,-935,114,18,0.709946849,신촌역(2호선) 1번출구 옆,봉원고가차도 밑,http://map.daum.net/?sName=신촌역(2호선) 1번출구 옆 대여소&eName=봉원고가차도 밑 대여소&target=bicycle
134,162,187,637,4361,4129,-450,232,9,0.546116505,연세로 명물길,봉원고가차도 밑,http://map.daum.net/?sName=연세로 명물길 대여소&eName=봉원고가차도 밑 대여소&target=bicycle
132,162,80,233,6680,6284,-153,396,3,0.488817891,창천문화공원,봉원고가차도 밑,http://map.daum.net/?sName=창천문화공원 대여소&eName=봉원고가차도 밑 대여소&target=bicycle
140,162,383,822,4249,4165,-439,84,8,0.364315353,이화여대 후문,봉원고가차도 밑,http://map.daum.net/?sName=이화여대 후문 대여소&eName=봉원고가차도 밑 대여소&target=bicycle
135,162,262,549,3745,3683,-287,62,5,0.353884094,명물길 원형무대 앞,봉원고가차도 밑,http://map.daum.net/?sName=명물길 원형무대 앞 대여소&eName=봉원고가차도 밑 대여소&target=bicycle
128,144,171,42,9612,9498,129,114,2,0.605633803,신촌역(2호선) 1번출구 옆,공덕역 8번출구,http://map.daum.net/?sName=신촌역(2호선) 1번출구 옆 대여소&eName=공덕역 8번출구 대여소&target=bicycle
114,144,208,331,13563,13818,-123,-255,2,0.228200371,홍대입구역 8번출구 앞,공덕역 8번출구,http://map.daum.net/?sName=홍대입구역 8번출구 앞 대여소&eName=공덕역 8번출구 대여소&target=bicycle
127,144,217,87,3056,2016,130,1040,2,0.427631579,현대벤처빌 앞,공덕역 8번출구,http://map.daum.net/?sName=현대벤처빌 앞 대여소&eName=공덕역 8번출구 대여소&target=bicycle
128,137,77,260,9612,9498,-183,114,3,0.543026706,신촌역(2호선) 1번출구 옆,NH농협 신촌지점 앞,http://map.daum.net/?sName=신촌역(2호선) 1번출구 옆 대여소&eName=NH농협 신촌지점 앞 대여소&target=bicycle
126,137,50,197,10989,11438,-147,-449,2,0.5951417,서강대 후문 옆,NH농협 신촌지점 앞,http://map.daum.net/?sName=서강대 후문 옆 대여소&eName=NH농협 신촌지점 앞 대여소&target=bicycle
128,139,158,489,9612,9498,-331,114,6,0.511591963,신촌역(2호선) 1번출구 옆,연세대 정문 건너편,http://map.daum.net/?sName=신촌역(2호선) 1번출구 옆 대여소&eName=연세대 정문 건너편 대여소&target=bicycle
128,159,85,190,9612,9498,-105,114,2,0.381818182,신촌역(2호선) 1번출구 옆,이대역 4번 출구,http://map.daum.net/?sName=신촌역(2호선) 1번출구 옆 대여소&eName=이대역 4번 출구 대여소&target=bicycle
126,159,83,441,10989,11438,-358,-449,7,0.683206107,서강대 후문 옆,이대역 4번 출구,http://map.daum.net/?sName=서강대 후문 옆 대여소&eName=이대역 4번 출구 대여소&target=bicycle
125,159,45,231,7982,7956,-186,26,3,0.673913043,서강대 남문 옆,이대역 4번 출구,http://map.daum.net/?sName=서강대 남문 옆 대여소&eName=이대역 4번 출구 대여소&target=bicycle
142,159,98,179,4788,4640,-81,148,1,0.292418773,아현역 4번출구 앞,이대역 4번 출구,http://map.daum.net/?sName=아현역 4번출구 앞 대여소&eName=이대역 4번 출구 대여소&target=bicycle
132,159,60,143,6680,6284,-83,396,1,0.408866995,창천문화공원,이대역 4번 출구,http://map.daum.net/?sName=창천문화공원 대여소&eName=이대역 4번 출구 대여소&target=bicycle
3503,551,210,36,2102,1075,174,1027,3,0.707317073,광진유진스웰,구의삼성쉐르빌 앞,http://map.daum.net/?sName=광진유진스웰 대여소&eName=구의삼성쉐르빌 앞 대여소&target=bicycle
501,551,181,87,17654,17669,94,-15,1,0.350746269,광진구의회 앞,구의삼성쉐르빌 앞,http://map.daum.net/?sName=광진구의회 앞 대여소&eName=구의삼성쉐르빌 앞 대여소&target=bicycle
3507,551,164,97,4854,3027,67,1827,1,0.256704981,어린이회관,구의삼성쉐르빌 앞,http://map.daum.net/?sName=어린이회관 대여소&eName=구의삼성쉐르빌 앞 대여소&target=bicycle
3524,551,93,152,2164,2020,-59,144,1,0.240816327,세종대학교,구의삼성쉐르빌 앞,http://map.daum.net/?sName=세종대학교 대여소&eName=구의삼성쉐르빌 앞 대여소&target=bicycle
3503,577,198,63,2102,1075,135,1027,2,0.517241379,광진유진스웰,광진청소년수련관,http://map.daum.net/?sName=광진유진스웰 대여소&eName=광진청소년수련관 대여소&target=bicycle
1209,577,72,128,14401,14405,-56,-4,1,0.28,잠실나루역 (2번 출구 쪽),광진청소년수련관,http://map.daum.net/?sName=잠실나루역 (2번 출구 쪽) 대여소&eName=광진청소년수련관 대여소&target=bicycle
551,577,380,245,8683,8849,135,-166,2,0.216,구의삼성쉐르빌 앞,광진청소년수련관,http://map.daum.net/?sName=구의삼성쉐르빌 앞 대여소&eName=광진청소년수련관 대여소&target=bicycle
3503,576,234,105,2102,1075,129,1027,2,0.380530973,광진유진스웰,광나루역 3번 출구,http://map.daum.net/?sName=광진유진스웰 대여소&eName=광나루역 3번 출구 대여소&target=bicycle
574,576,148,58,8690,6843,90,1847,1,0.436893204,아차산역4번출구,광나루역 3번 출구,http://map.daum.net/?sName=아차산역4번출구 대여소&eName=광나루역 3번 출구 대여소&target=bicycle
542,576,304,167,7692,7609,137,83,2,0.290870488,강변역 4번출구 뒤,광나루역 3번 출구,http://map.daum.net/?sName=강변역 4번출구 뒤 대여소&eName=광나루역 3번 출구 대여소&target=bicycle
544,576,123,190,3517,3806,-67,-289,1,0.214057508,광남중학교,광나루역 3번 출구,http://map.daum.net/?sName=광남중학교 대여소&eName=광나루역 3번 출구 대여소&target=bicycle
3511,535,57,327,7572,9061,-270,-1489,5,0.703125,응봉역 1번출구,응봉삼거리,http://map.daum.net/?sName=응봉역 1번출구 대여소&eName=응봉삼거리 대여소&target=bicycle
521,535,105,200,8077,7780,-95,297,1,0.31147541,왕십리역 11번 출구 앞,응봉삼거리,http://map.daum.net/?sName=왕십리역 11번 출구 앞 대여소&eName=응봉삼거리 대여소&target=bicycle
3511,559,150,294,7572,9061,-144,-1489,2,0.324324324,응봉역 1번출구,왕십리역 4번 출구 건너편,http://map.daum.net/?sName=응봉역 1번출구 대여소&eName=왕십리역 4번 출구 건너편 대여소&target=bicycle
535,559,309,108,3792,2126,201,1666,4,0.482014388,응봉삼거리,왕십리역 4번 출구 건너편,http://map.daum.net/?sName=응봉삼거리 대여소&eName=왕십리역 4번 출구 건너편 대여소&target=bicycle
502,559,69,192,40455,46318,-123,-5863,2,0.471264368,뚝섬유원지역 1번출구 앞,왕십리역 4번 출구 건너편,http://map.daum.net/?sName=뚝섬유원지역 1번출구 앞 대여소&eName=왕십리역 4번 출구 건너편 대여소&target=bicycle
3513,559,437,283,7483,4882,154,2601,3,0.213888889,상왕십리역 1번출구,왕십리역 4번 출구 건너편,http://map.daum.net/?sName=상왕십리역 1번출구 대여소&eName=왕십리역 4번 출구 건너편 대여소&target=bicycle
518,559,173,90,3645,3560,83,85,1,0.315589354,청계천 박물관 앞,왕십리역 4번 출구 건너편,http://map.daum.net/?sName=청계천 박물관 앞 대여소&eName=왕십리역 4번 출구 건너편 대여소&target=bicycle
3522,559,77,173,7516,8547,-96,-1031,1,0.384,사근삼거리,왕십리역 4번 출구 건너편,http://map.daum.net/?sName=사근삼거리 대여소&eName=왕십리역 4번 출구 건너편 대여소&target=bicycle
3511,521,71,135,7572,9061,-64,-1489,1,0.310679612,응봉역 1번출구,왕십리역 11번 출구 앞,http://map.daum.net/?sName=응봉역 1번출구 대여소&eName=왕십리역 11번 출구 앞 대여소&target=bicycle
347,521,141,79,8262,7773,62,489,1,0.281818182,동대문역사문화공원역 9번출구 앞,왕십리역 11번 출구 앞,http://map.daum.net/?sName=동대문역사문화공원역 9번출구 앞 대여소&eName=왕십리역 11번 출구 앞 대여소&target=bicycle
212,244,190,34,13214,5886,156,7328,3,0.696428571,여의도역 1번출구 옆,영등포삼환아파트 앞,http://map.daum.net/?sName=여의도역 1번출구 옆 대여소&eName=영등포삼환아파트 앞 대여소&target=bicycle
206,244,166,41,8174,7845,125,329,2,0.603864734,KBS 앞,영등포삼환아파트 앞,http://map.daum.net/?sName=KBS 앞 대여소&eName=영등포삼환아파트 앞 대여소&target=bicycle
212,222,429,98,13214,5886,331,7328,6,0.628083491,여의도역 1번출구 옆,시범아파트버스정류장 옆,http://map.daum.net/?sName=여의도역 1번출구 옆 대여소&eName=시범아파트버스정류장 옆 대여소&target=bicycle
217,222,268,416,8072,8825,-148,-753,2,0.216374269,NH농협은행 앞,시범아파트버스정류장 옆,http://map.daum.net/?sName=NH농협은행 앞 대여소&eName=시범아파트버스정류장 옆 대여소&target=bicycle
207,222,1825,1002,48130,45467,823,2663,16,0.29112133,여의나루역 1번출구 앞,시범아파트버스정류장 옆,http://map.daum.net/?sName=여의나루역 1번출구 앞 대여소&eName=시범아파트버스정류장 옆 대여소&target=bicycle
220,222,203,111,7551,4988,92,2563,1,0.292993631,미성아파트 A동 앞,시범아파트버스정류장 옆,http://map.daum.net/?sName=미성아파트 A동 앞 대여소&eName=시범아파트버스정류장 옆 대여소&target=bicycle
215,222,135,78,5285,6023,57,-738,1,0.267605634,여의도고교 앞,시범아파트버스정류장 옆,http://map.daum.net/?sName=여의도고교 앞 대여소&eName=시범아파트버스정류장 옆 대여소&target=bicycle
209,222,257,426,5928,5839,-169,89,3,0.247437775,유진투자증권빌딩 앞,시범아파트버스정류장 옆,http://map.daum.net/?sName=유진투자증권빌딩 앞 대여소&eName=시범아파트버스정류장 옆 대여소&target=bicycle
218,222,151,96,3700,3112,55,588,1,0.222672065,증권거래소 앞,시범아파트버스정류장 옆,http://map.daum.net/?sName=증권거래소 앞 대여소&eName=시범아파트버스정류장 옆 대여소&target=bicycle
212,223,323,85,13214,5886,238,7328,4,0.583333333,여의도역 1번출구 옆,진주아파트상가 앞,http://map.daum.net/?sName=여의도역 1번출구 옆 대여소&eName=진주아파트상가 앞 대여소&target=bicycle
207,223,344,167,48130,45467,177,2663,3,0.346379648,여의나루역 1번출구 앞,진주아파트상가 앞,http://map.daum.net/?sName=여의나루역 1번출구 앞 대여소&eName=진주아파트상가 앞 대여소&target=bicycle
213,223,98,156,8227,6685,-58,1542,1,0.228346457,KT앞,진주아파트상가 앞,http://map.daum.net/?sName=KT앞 대여소&eName=진주아파트상가 앞 대여소&target=bicycle
220,223,267,141,7551,4988,126,2563,2,0.308823529,미성아파트 A동 앞,진주아파트상가 앞,http://map.daum.net/?sName=미성아파트 A동 앞 대여소&eName=진주아파트상가 앞 대여소&target=bicycle
210,223,139,264,20427,20741,-125,-314,2,0.310173697,IFC몰,진주아파트상가 앞,http://map.daum.net/?sName=IFC몰 대여소&eName=진주아파트상가 앞 대여소&target=bicycle
219,223,136,212,5423,5084,-76,339,1,0.218390805,롯데캐슬엠파이어 옆,진주아파트상가 앞,http://map.daum.net/?sName=롯데캐슬엠파이어 옆 대여소&eName=진주아파트상가 앞 대여소&target=bicycle
212,276,176,47,13214,5886,129,7328,2,0.578475336,여의도역 1번출구 옆,SK 영등포주유소,http://map.daum.net/?sName=여의도역 1번출구 옆 대여소&eName=SK 영등포주유소 대여소&target=bicycle
214,276,232,141,5718,4078,91,1640,1,0.243967828,금융감독원 앞,SK 영등포주유소,http://map.daum.net/?sName=금융감독원 앞 대여소&eName=SK 영등포주유소 대여소&target=bicycle
211,276,146,85,12700,11273,61,1427,1,0.264069264,여의도역 4번출구 옆,SK 영등포주유소,http://map.daum.net/?sName=여의도역 4번출구 옆 대여소&eName=SK 영등포주유소 대여소&target=bicycle
205,276,87,232,7337,7031,-145,306,2,0.454545455,산업은행 앞,SK 영등포주유소,http://map.daum.net/?sName=산업은행 앞 대여소&eName=SK 영등포주유소 대여소&target=bicycle
220,276,139,67,7551,4988,72,2563,1,0.349514563,미성아파트 A동 앞,SK 영등포주유소,http://map.daum.net/?sName=미성아파트 A동 앞 대여소&eName=SK 영등포주유소 대여소&target=bicycle
212,257,370,152,13214,5886,218,7328,4,0.417624521,여의도역 1번출구 옆,신길삼거리(우리은행),http://map.daum.net/?sName=여의도역 1번출구 옆 대여소&eName=신길삼거리(우리은행) 대여소&target=bicycle
217,257,79,137,8072,8825,-58,-753,1,0.268518519,NH농협은행 앞,신길삼거리(우리은행),http://map.daum.net/?sName=NH농협은행 앞 대여소&eName=신길삼거리(우리은행) 대여소&target=bicycle
213,257,155,82,8227,6685,73,1542,1,0.308016878,KT앞,신길삼거리(우리은행),http://map.daum.net/?sName=KT앞 대여소&eName=신길삼거리(우리은행) 대여소&target=bicycle
220,257,167,85,7551,4988,82,2563,1,0.325396825,미성아파트 A동 앞,신길삼거리(우리은행),http://map.daum.net/?sName=미성아파트 A동 앞 대여소&eName=신길삼거리(우리은행) 대여소&target=bicycle
2007,257,488,221,6298,6167,267,131,5,0.376586742,유한양행앞,신길삼거리(우리은행),http://map.daum.net/?sName=유한양행앞 대여소&eName=신길삼거리(우리은행) 대여소&target=bicycle
250,257,130,79,3229,3392,51,-163,1,0.244019139,대림아파트 사거리,신길삼거리(우리은행),http://map.daum.net/?sName=대림아파트 사거리 대여소&eName=신길삼거리(우리은행) 대여소&target=bicycle
2063,257,387,240,5444,5396,147,48,2,0.234449761,대방역 4번출구,신길삼거리(우리은행),http://map.daum.net/?sName=대방역 4번출구 대여소&eName=신길삼거리(우리은행) 대여소&target=bicycle
226,257,273,181,7843,5716,92,2127,1,0.202643172,샛강역 1번출구 앞,신길삼거리(우리은행),http://map.daum.net/?sName=샛강역 1번출구 앞 대여소&eName=신길삼거리(우리은행) 대여소&target=bicycle
212,224,320,145,13214,5886,175,7328,3,0.376344086,여의도역 1번출구 옆,롯데캐슬 앞,http://map.daum.net/?sName=여의도역 1번출구 옆 대여소&eName=롯데캐슬 앞 대여소&target=bicycle
220,224,270,157,7551,4988,113,2563,2,0.264637002,미성아파트 A동 앞,롯데캐슬 앞,http://map.daum.net/?sName=미성아파트 A동 앞 대여소&eName=롯데캐슬 앞 대여소&target=bicycle
219,224,260,144,5423,5084,116,339,2,0.287128713,롯데캐슬엠파이어 옆,롯데캐슬 앞,http://map.daum.net/?sName=롯데캐슬엠파이어 옆 대여소&eName=롯데캐슬 앞 대여소&target=bicycle
201,224,96,170,7801,7985,-74,-184,1,0.278195489,진미파라곤 앞,롯데캐슬 앞,http://map.daum.net/?sName=진미파라곤 앞 대여소&eName=롯데캐슬 앞 대여소&target=bicycle
212,216,188,114,13214,5886,74,7328,1,0.245033113,여의도역 1번출구 옆,삼부아파트1동 앞,http://map.daum.net/?sName=여의도역 1번출구 옆 대여소&eName=삼부아파트1동 앞 대여소&target=bicycle
126,147,87,160,10989,11438,-73,-449,1,0.295546559,서강대 후문 옆,마포역 4번출구 뒤,http://map.daum.net/?sName=서강대 후문 옆 대여소&eName=마포역 4번출구 뒤 대여소&target=bicycle
126,128,92,153,10989,11438,-61,-449,1,0.248979592,서강대 후문 옆,신촌역(2호선) 1번출구 옆,http://map.daum.net/?sName=서강대 후문 옆 대여소&eName=신촌역(2호선) 1번출구 옆 대여소&target=bicycle
114,128,223,380,13563,13818,-157,-255,3,0.260364842,홍대입구역 8번출구 앞,신촌역(2호선) 1번출구 옆,http://map.daum.net/?sName=홍대입구역 8번출구 앞 대여소&eName=신촌역(2호선) 1번출구 옆 대여소&target=bicycle
118,128,51,185,7742,7577,-134,165,2,0.56779661,광흥창역 2번출구 앞,신촌역(2호선) 1번출구 옆,http://map.daum.net/?sName=광흥창역 2번출구 앞 대여소&eName=신촌역(2호선) 1번출구 옆 대여소&target=bicycle
115,128,140,223,8254,7077,-83,1177,1,0.228650138,사루비아 빌딩 앞,신촌역(2호선) 1번출구 옆,http://map.daum.net/?sName=사루비아 빌딩 앞 대여소&eName=신촌역(2호선) 1번출구 옆 대여소&target=bicycle
121,128,93,179,4697,4440,-86,257,1,0.316176471,마포소방서 앞,신촌역(2호선) 1번출구 옆,http://map.daum.net/?sName=마포소방서 앞 대여소&eName=신촌역(2호선) 1번출구 옆 대여소&target=bicycle
112,128,144,220,8678,8465,-76,213,1,0.208791209,극동방송국 앞,신촌역(2호선) 1번출구 옆,http://map.daum.net/?sName=극동방송국 앞 대여소&eName=신촌역(2호선) 1번출구 옆 대여소&target=bicycle
126,127,212,344,10989,11438,-132,-449,2,0.237410072,서강대 후문 옆,현대벤처빌 앞,http://map.daum.net/?sName=서강대 후문 옆 대여소&eName=현대벤처빌 앞 대여소&target=bicycle
126,129,629,400,10989,11438,229,-449,4,0.222546161,서강대 후문 옆,신촌역(2호선) 6번출구 옆,http://map.daum.net/?sName=서강대 후문 옆 대여소&eName=신촌역(2호선) 6번출구 옆 대여소&target=bicycle
114,129,92,199,13563,13818,-107,-255,2,0.367697595,홍대입구역 8번출구 앞,신촌역(2호선) 6번출구 옆,http://map.daum.net/?sName=홍대입구역 8번출구 앞 대여소&eName=신촌역(2호선) 6번출구 옆 대여소&target=bicycle
124,129,355,196,7757,6792,159,965,3,0.288566243,서강대 정문 건너편,신촌역(2호선) 6번출구 옆,http://map.daum.net/?sName=서강대 정문 건너편 대여소&eName=신촌역(2호선) 6번출구 옆 대여소&target=bicycle
574,588,184,35,8690,6843,149,1847,2,0.680365297,아차산역4번출구,뚝섬 유원지역,http://map.daum.net/?sName=아차산역4번출구 대여소&eName=뚝섬 유원지역 대여소&target=bicycle
502,588,520,934,40455,46318,-414,-5863,8,0.284731774,뚝섬유원지역 1번출구 앞,뚝섬 유원지역,http://map.daum.net/?sName=뚝섬유원지역 1번출구 앞 대여소&eName=뚝섬 유원지역 대여소&target=bicycle
3505,588,173,102,5644,4650,71,994,1,0.258181818,신양초교앞 교차로,뚝섬 유원지역,http://map.daum.net/?sName=신양초교앞 교차로 대여소&eName=뚝섬 유원지역 대여소&target=bicycle
565,588,77,158,16203,18398,-81,-2195,1,0.344680851,옥수역 3번출구,뚝섬 유원지역,http://map.daum.net/?sName=옥수역 3번출구 대여소&eName=뚝섬 유원지역 대여소&target=bicycle
505,588,147,224,14171,13812,-77,359,1,0.20754717,자양사거리 광진아크로텔 앞,뚝섬 유원지역,http://map.daum.net/?sName=자양사거리 광진아크로텔 앞 대여소&eName=뚝섬 유원지역 대여소&target=bicycle
574,590,344,151,8690,6843,193,1847,3,0.38989899,아차산역4번출구,건국대학교 (입학정보관),http://map.daum.net/?sName=아차산역4번출구 대여소&eName=건국대학교 (입학정보관) 대여소&target=bicycle
1231,590,79,138,12608,12435,-59,173,1,0.271889401,잠실역 6번출구,건국대학교 (입학정보관),http://map.daum.net/?sName=잠실역 6번출구 대여소&eName=건국대학교 (입학정보관) 대여소&target=bicycle
571,590,364,134,10650,8548,230,2102,4,0.46184739,어린이대공원역6번출구,건국대학교 (입학정보관),http://map.daum.net/?sName=어린이대공원역6번출구 대여소&eName=건국대학교 (입학정보관) 대여소&target=bicycle
3507,590,313,200,4854,3027,113,1827,2,0.220272904,어린이회관,건국대학교 (입학정보관),http://map.daum.net/?sName=어린이회관 대여소&eName=건국대학교 (입학정보관) 대여소&target=bicycle
584,590,251,98,11250,8295,153,2955,3,0.438395415,광진광장 교통섬,건국대학교 (입학정보관),http://map.daum.net/?sName=광진광장 교통섬 대여소&eName=건국대학교 (입학정보관) 대여소&target=bicycle
514,590,152,95,11672,12181,57,-509,1,0.230769231,성수사거리 버스정류장 앞,건국대학교 (입학정보관),http://map.daum.net/?sName=성수사거리 버스정류장 앞 대여소&eName=건국대학교 (입학정보관) 대여소&target=bicycle
548,590,119,200,8482,8082,-81,400,1,0.253918495,자양나들목,건국대학교 (입학정보관),http://map.daum.net/?sName=자양나들목 대여소&eName=건국대학교 (입학정보관) 대여소&target=bicycle
2222,2284,41,212,6171,7406,-171,-1235,3,0.675889328,사당역 12번출구 뒤,CJ오쇼핑앞,http://map.daum.net/?sName=사당역 12번출구 뒤 대여소&eName=CJ오쇼핑앞 대여소&target=bicycle
2104,2284,68,250,4192,5129,-182,-937,3,0.572327044,사당역 5번출구,CJ오쇼핑앞,http://map.daum.net/?sName=사당역 5번출구 대여소&eName=CJ오쇼핑앞 대여소&target=bicycle
2222,2225,41,185,6171,7406,-144,-1235,2,0.637168142,사당역 12번출구 뒤,백석예술대학교 제3캠퍼스 앞,http://map.daum.net/?sName=사당역 12번출구 뒤 대여소&eName=백석예술대학교 제3캠퍼스 앞 대여소&target=bicycle
2104,2225,38,168,4192,5129,-130,-937,2,0.631067961,사당역 5번출구,백석예술대학교 제3캠퍼스 앞,http://map.daum.net/?sName=사당역 5번출구 대여소&eName=백석예술대학교 제3캠퍼스 앞 대여소&target=bicycle
2222,2281,147,275,6171,7406,-128,-1235,2,0.303317536,사당역 12번출구 뒤,연세사랑병원신관앞,http://map.daum.net/?sName=사당역 12번출구 뒤 대여소&eName=연세사랑병원신관앞 대여소&target=bicycle
125,134,176,111,7982,7956,65,26,1,0.226480836,서강대 남문 옆,연세로 명물길,http://map.daum.net/?sName=서강대 남문 옆 대여소&eName=연세로 명물길 대여소&target=bicycle
1337,1344,75,380,12539,12802,-305,-263,6,0.67032967,돈암성당 옆,아리랑시네센터 앞,http://map.daum.net/?sName=돈암성당 옆 대여소&eName=아리랑시네센터 앞 대여소&target=bicycle
1316,1344,51,166,2445,1306,-115,1139,2,0.529953917,고려사대부속중고 건너편,아리랑시네센터 앞,http://map.daum.net/?sName=고려사대부속중고 건너편 대여소&eName=아리랑시네센터 앞 대여소&target=bicycle
1303,1344,65,166,5357,5252,-101,105,2,0.437229437,돈암초교 입구,아리랑시네센터 앞,http://map.daum.net/?sName=돈암초교 입구 대여소&eName=아리랑시네센터 앞 대여소&target=bicycle
1337,1355,674,311,12539,12802,363,-263,7,0.368527919,돈암성당 옆,보문2교,http://map.daum.net/?sName=돈암성당 옆 대여소&eName=보문2교 대여소&target=bicycle
1305,1355,240,107,4475,4216,133,259,2,0.383285303,성북구청,보문2교,http://map.daum.net/?sName=성북구청 대여소&eName=보문2교 대여소&target=bicycle
1336,1355,325,195,6085,5878,130,207,2,0.25,성북3교 위,보문2교,http://map.daum.net/?sName=성북3교 위 대여소&eName=보문2교 대여소&target=bicycle
1337,342,87,188,12539,12802,-101,-263,2,0.367272727,돈암성당 옆,대학로 마로니에공원,http://map.daum.net/?sName=돈암성당 옆 대여소&eName=대학로 마로니에공원 대여소&target=bicycle
1306,342,277,182,7479,7356,95,123,1,0.206971678,한성대입구역2번출구,대학로 마로니에공원,http://map.daum.net/?sName=한성대입구역2번출구 대여소&eName=대학로 마로니에공원 대여소&target=bicycle
329,342,92,151,8131,7863,-59,268,1,0.242798354,청계2가 사거리 옆,대학로 마로니에공원,http://map.daum.net/?sName=청계2가 사거리 옆 대여소&eName=대학로 마로니에공원 대여소&target=bicycle
1337,340,100,200,12539,12802,-100,-263,2,0.333333333,돈암성당 옆,혜화동 로터리,http://map.daum.net/?sName=돈암성당 옆 대여소&eName=혜화동 로터리 대여소&target=bicycle
337,340,119,181,2626,2504,-62,122,1,0.206666667,창경궁 입구,혜화동 로터리,http://map.daum.net/?sName=창경궁 입구 대여소&eName=혜화동 로터리 대여소&target=bicycle
1337,1343,98,193,12539,12802,-95,-263,1,0.326460481,돈암성당 옆,한성대7번출구 앞,http://map.daum.net/?sName=돈암성당 옆 대여소&eName=한성대7번출구 앞 대여소&target=bicycle
217,226,91,456,8072,8825,-365,-753,7,0.667276051,NH농협은행 앞,샛강역 1번출구 앞,http://map.daum.net/?sName=NH농협은행 앞 대여소&eName=샛강역 1번출구 앞 대여소&target=bicycle
221,226,68,155,7796,8567,-87,-771,1,0.390134529,여의도초교 앞,샛강역 1번출구 앞,http://map.daum.net/?sName=여의도초교 앞 대여소&eName=샛강역 1번출구 앞 대여소&target=bicycle
223,226,90,168,6759,6451,-78,308,1,0.302325581,진주아파트상가 앞,샛강역 1번출구 앞,http://map.daum.net/?sName=진주아파트상가 앞 대여소&eName=샛강역 1번출구 앞 대여소&target=bicycle
222,226,187,355,13549,15025,-168,-1476,3,0.3099631,시범아파트버스정류장 옆,샛강역 1번출구 앞,http://map.daum.net/?sName=시범아파트버스정류장 옆 대여소&eName=샛강역 1번출구 앞 대여소&target=bicycle
217,270,67,137,8072,8825,-70,-753,1,0.343137255,NH농협은행 앞,증권거래소후문교차로,http://map.daum.net/?sName=NH농협은행 앞 대여소&eName=증권거래소후문교차로 대여소&target=bicycle
216,270,137,79,6399,6478,58,-79,1,0.268518519,삼부아파트1동 앞,증권거래소후문교차로,http://map.daum.net/?sName=삼부아파트1동 앞 대여소&eName=증권거래소후문교차로 대여소&target=bicycle
217,259,662,1203,8072,8825,-541,-753,10,0.290080429,NH농협은행 앞,대방역6번출구,http://map.daum.net/?sName=NH농협은행 앞 대여소&eName=대방역6번출구 대여소&target=bicycle
206,259,171,272,8174,7845,-101,329,2,0.227990971,KBS 앞,대방역6번출구,http://map.daum.net/?sName=KBS 앞 대여소&eName=대방역6번출구 대여소&target=bicycle
207,259,391,239,48130,45467,152,2663,3,0.241269841,여의나루역 1번출구 앞,대방역6번출구,http://map.daum.net/?sName=여의나루역 1번출구 앞 대여소&eName=대방역6번출구 대여소&target=bicycle
213,259,173,424,8227,6685,-251,1542,5,0.420435511,KT앞,대방역6번출구,http://map.daum.net/?sName=KT앞 대여소&eName=대방역6번출구 대여소&target=bicycle
205,259,197,130,7337,7031,67,306,1,0.204892966,산업은행 앞,대방역6번출구,http://map.daum.net/?sName=산업은행 앞 대여소&eName=대방역6번출구 대여소&target=bicycle
209,259,112,202,5928,5839,-90,89,1,0.286624204,유진투자증권빌딩 앞,대방역6번출구,http://map.daum.net/?sName=유진투자증권빌딩 앞 대여소&eName=대방역6번출구 대여소&target=bicycle
201,259,105,165,7801,7985,-60,-184,1,0.222222222,진미파라곤 앞,대방역6번출구,http://map.daum.net/?sName=진미파라곤 앞 대여소&eName=대방역6번출구 대여소&target=bicycle
217,219,138,245,8072,8825,-107,-753,2,0.279373368,NH농협은행 앞,롯데캐슬엠파이어 옆,http://map.daum.net/?sName=NH농협은행 앞 대여소&eName=롯데캐슬엠파이어 옆 대여소&target=bicycle
403,408,202,41,3507,1524,161,1983,3,0.66255144,부엉이공원 앞,LG CNS앞,http://map.daum.net/?sName=부엉이공원 앞 대여소&eName=LG CNS앞 대여소&target=bicycle
407,408,132,212,4377,4263,-80,114,1,0.23255814,마포구 육아종합지원센터,LG CNS앞,http://map.daum.net/?sName=마포구 육아종합지원센터 대여소&eName=LG CNS앞 대여소&target=bicycle
402,408,417,278,5010,4687,139,323,2,0.2,상암월드컵파크 9단지 앞,LG CNS앞,http://map.daum.net/?sName=상암월드컵파크 9단지 앞 대여소&eName=LG CNS앞 대여소&target=bicycle
403,409,338,90,3507,1524,248,1983,4,0.579439252,부엉이공원 앞,누리꿈스퀘어 옆,http://map.daum.net/?sName=부엉이공원 앞 대여소&eName=누리꿈스퀘어 옆 대여소&target=bicycle
133,409,222,141,6119,7437,81,-1318,1,0.223140496,해담는다리,누리꿈스퀘어 옆,http://map.daum.net/?sName=해담는다리 대여소&eName=누리꿈스퀘어 옆 대여소&target=bicycle
178,409,209,124,3419,3650,85,-231,1,0.255255255,증산3교 앞,누리꿈스퀘어 옆,http://map.daum.net/?sName=증산3교 앞 대여소&eName=누리꿈스퀘어 옆 대여소&target=bicycle
403,417,155,70,3507,1524,85,1983,1,0.377777778,부엉이공원 앞,DMC역 2번출구 옆,http://map.daum.net/?sName=부엉이공원 앞 대여소&eName=DMC역 2번출구 옆 대여소&target=bicycle
416,417,420,151,5281,2301,269,2980,5,0.471103327,상암월드컵파크 1단지 교차로,DMC역 2번출구 옆,http://map.daum.net/?sName=상암월드컵파크 1단지 교차로 대여소&eName=DMC역 2번출구 옆 대여소&target=bicycle
166,417,152,53,8122,8785,99,-663,1,0.482926829,가재울 초등학교,DMC역 2번출구 옆,http://map.daum.net/?sName=가재울 초등학교 대여소&eName=DMC역 2번출구 옆 대여소&target=bicycle
407,417,57,157,4377,4263,-100,114,2,0.46728972,마포구 육아종합지원센터,DMC역 2번출구 옆,http://map.daum.net/?sName=마포구 육아종합지원센터 대여소&eName=DMC역 2번출구 옆 대여소&target=bicycle
133,417,85,203,6119,7437,-118,-1318,2,0.409722222,해담는다리,DMC역 2번출구 옆,http://map.daum.net/?sName=해담는다리 대여소&eName=DMC역 2번출구 옆 대여소&target=bicycle
409,417,502,957,11080,13610,-455,-2530,9,0.311857437,누리꿈스퀘어 옆,DMC역 2번출구 옆,http://map.daum.net/?sName=누리꿈스퀘어 옆 대여소&eName=DMC역 2번출구 옆 대여소&target=bicycle
405,417,223,388,2985,3348,-165,-363,3,0.2700491,DMC빌 앞,DMC역 2번출구 옆,http://map.daum.net/?sName=DMC빌 앞 대여소&eName=DMC역 2번출구 옆 대여소&target=bicycle
408,417,219,339,5319,5664,-120,-345,2,0.215053763,LG CNS앞,DMC역 2번출구 옆,http://map.daum.net/?sName=LG CNS앞 대여소&eName=DMC역 2번출구 옆 대여소&target=bicycle
363,520,38,181,6477,7008,-143,-531,2,0.652968037,신설동역 11번출구 뒤,상왕십리역 4번 출구 앞,http://map.daum.net/?sName=신설동역 11번출구 뒤 대여소&eName=상왕십리역 4번 출구 앞 대여소&target=bicycle
363,568,157,254,6477,7008,-97,-531,1,0.236009732,신설동역 11번출구 뒤,청계8가사거리 부근,http://map.daum.net/?sName=신설동역 11번출구 뒤 대여소&eName=청계8가사거리 부근 대여소&target=bicycle
3513,568,723,334,7483,4882,389,2601,7,0.368022706,상왕십리역 1번출구,청계8가사거리 부근,http://map.daum.net/?sName=상왕십리역 1번출구 대여소&eName=청계8가사거리 부근 대여소&target=bicycle
530,568,191,406,4597,5182,-215,-585,4,0.360134003,청계벽산아파트 앞,청계8가사거리 부근,http://map.daum.net/?sName=청계벽산아파트 앞 대여소&eName=청계8가사거리 부근 대여소&target=bicycle
520,568,212,113,4647,3529,99,1118,1,0.304615385,상왕십리역 4번 출구 앞,청계8가사거리 부근,http://map.daum.net/?sName=상왕십리역 4번 출구 앞 대여소&eName=청계8가사거리 부근 대여소&target=bicycle
519,568,366,217,5106,3820,149,1286,2,0.255574614,양지사거리,청계8가사거리 부근,http://map.daum.net/?sName=양지사거리 대여소&eName=청계8가사거리 부근 대여소&target=bicycle
347,568,150,94,8262,7773,56,489,1,0.229508197,동대문역사문화공원역 9번출구 앞,청계8가사거리 부근,http://map.daum.net/?sName=동대문역사문화공원역 9번출구 앞 대여소&eName=청계8가사거리 부근 대여소&target=bicycle
363,383,94,148,6477,7008,-54,-531,1,0.223140496,신설동역 11번출구 뒤,신당역 12번 출구 뒤,http://map.daum.net/?sName=신설동역 11번출구 뒤 대여소&eName=신당역 12번 출구 뒤 대여소&target=bicycle
378,383,170,256,7304,7234,-86,70,1,0.201877934,청계7가 사거리,신당역 12번 출구 뒤,http://map.daum.net/?sName=청계7가 사거리 대여소&eName=신당역 12번 출구 뒤 대여소&target=bicycle
1016,1025,48,220,2684,3110,-172,-426,3,0.641791045,해뜨는 주유소옆 리엔파크 109동앞,상일초등학교,http://map.daum.net/?sName=해뜨는 주유소옆 리엔파크 109동앞 대여소&eName=상일초등학교 대여소&target=bicycle
1016,1035,200,410,2684,3110,-210,-426,4,0.344262295,해뜨는 주유소옆 리엔파크 109동앞,고덕역 4번출구,http://map.daum.net/?sName=해뜨는 주유소옆 리엔파크 109동앞 대여소&eName=고덕역 4번출구 대여소&target=bicycle
1021,1035,165,332,3814,4080,-167,-266,3,0.336016097,강일동 리슈빌 빌딩앞,고덕역 4번출구,http://map.daum.net/?sName=강일동 리슈빌 빌딩앞 대여소&eName=고덕역 4번출구 대여소&target=bicycle
616,638,406,92,2433,982,314,1451,6,0.630522088,서울시립대 앞,서울시립대 정보기술관,http://map.daum.net/?sName=서울시립대 앞 대여소&eName=서울시립대 정보기술관 대여소&target=bicycle
623,638,2049,894,10901,6644,1155,4257,23,0.392456677,서울시립대 정문 앞,서울시립대 정보기술관,http://map.daum.net/?sName=서울시립대 정문 앞 대여소&eName=서울시립대 정보기술관 대여소&target=bicycle
622,638,201,307,5324,6318,-106,-994,2,0.208661417,전농사거리 교통섬,서울시립대 정보기술관,http://map.daum.net/?sName=전농사거리 교통섬 대여소&eName=서울시립대 정보기술관 대여소&target=bicycle
616,617,283,77,2433,982,206,1451,4,0.572222222,서울시립대 앞,청솔우성아파트 앞,http://map.daum.net/?sName=서울시립대 앞 대여소&eName=청솔우성아파트 앞 대여소&target=bicycle
616,622,323,124,2433,982,199,1451,3,0.445190157,서울시립대 앞,전농사거리 교통섬,http://map.daum.net/?sName=서울시립대 앞 대여소&eName=전농사거리 교통섬 대여소&target=bicycle
616,639,276,158,2433,982,118,1451,2,0.271889401,서울시립대 앞,서울시립대 후문,http://map.daum.net/?sName=서울시립대 앞 대여소&eName=서울시립대 후문 대여소&target=bicycle
634,639,71,250,13423,14371,-179,-948,3,0.557632399,외국어대 정문 앞,서울시립대 후문,http://map.daum.net/?sName=외국어대 정문 앞 대여소&eName=서울시립대 후문 대여소&target=bicycle
638,639,209,365,3968,4856,-156,-888,3,0.271777003,서울시립대 정보기술관,서울시립대 후문,http://map.daum.net/?sName=서울시립대 정보기술관 대여소&eName=서울시립대 후문 대여소&target=bicycle
633,639,104,176,6814,7452,-72,-638,1,0.257142857,청량리 기업은행 앞,서울시립대 후문,http://map.daum.net/?sName=청량리 기업은행 앞 대여소&eName=서울시립대 후문 대여소&target=bicycle
635,639,101,167,6882,7081,-66,-199,1,0.246268657,시조사 앞 (청량고정문 옆),서울시립대 후문,http://map.daum.net/?sName=시조사 앞 (청량고정문 옆) 대여소&eName=서울시립대 후문 대여소&target=bicycle
529,602,410,95,5457,4793,315,664,6,0.623762376,장한평역 8번 출구 앞,장안동 사거리,http://map.daum.net/?sName=장한평역 8번 출구 앞 대여소&eName=장안동 사거리 대여소&target=bicycle
553,602,360,109,4341,4839,251,-498,5,0.535181237,중곡 성원APT 앞,장안동 사거리,http://map.daum.net/?sName=중곡 성원APT 앞 대여소&eName=장안동 사거리 대여소&target=bicycle
1444,602,147,63,2493,3398,84,-905,1,0.4,면목4치안센터,장안동 사거리,http://map.daum.net/?sName=면목4치안센터 대여소&eName=장안동 사거리 대여소&target=bicycle
1440,602,191,89,3779,4353,102,-574,2,0.364285714,하나은행 면목지점,장안동 사거리,http://map.daum.net/?sName=하나은행 면목지점 대여소&eName=장안동 사거리 대여소&target=bicycle
3500,602,150,90,5750,5761,60,-11,1,0.25,군자역2번출구,장안동 사거리,http://map.daum.net/?sName=군자역2번출구 대여소&eName=장안동 사거리 대여소&target=bicycle
1434,602,175,109,2764,3422,66,-658,1,0.232394366,홈플러스 면목동점,장안동 사거리,http://map.daum.net/?sName=홈플러스 면목동점 대여소&eName=장안동 사거리 대여소&target=bicycle
539,602,166,109,6994,7043,57,-49,1,0.207272727,군자교교차로,장안동 사거리,http://map.daum.net/?sName=군자교교차로 대여소&eName=장안동 사거리 대여소&target=bicycle
529,643,194,49,5457,4793,145,664,2,0.596707819,장한평역 8번 출구 앞,동대문구민체육센터 (육교아래),http://map.daum.net/?sName=장한평역 8번 출구 앞 대여소&eName=동대문구민체육센터 (육교아래) 대여소&target=bicycle
578,643,138,73,6082,6401,65,-319,1,0.308056872,성동세무서 부근,동대문구민체육센터 (육교아래),http://map.daum.net/?sName=성동세무서 부근 대여소&eName=동대문구민체육센터 (육교아래) 대여소&target=bicycle
529,581,176,112,5457,4793,64,664,1,0.222222222,장한평역 8번 출구 앞,용답초등학교,http://map.daum.net/?sName=장한평역 8번 출구 앞 대여소&eName=용답초등학교 대여소&target=bicycle
1315,1357,48,206,2168,1614,-158,554,3,0.622047244,고려사대부속중고 정문,북한산보국문역,http://map.daum.net/?sName=고려사대부속중고 정문 대여소&eName=북한산보국문역 대여소&target=bicycle
1318,1357,88,141,4786,4831,-53,-45,1,0.231441048,길음역 3번출구 뒤,북한산보국문역,http://map.daum.net/?sName=길음역 3번출구 뒤 대여소&eName=북한산보국문역 대여소&target=bicycle
1315,1360,150,93,2168,1614,57,554,1,0.234567901,고려사대부속중고 정문,정릉역,http://map.daum.net/?sName=고려사대부속중고 정문 대여소&eName=정릉역 대여소&target=bicycle
802,803,268,63,2644,1674,205,970,4,0.619335347,한강진역 2번 출구 앞,한남초교 앞 보도육교,http://map.daum.net/?sName=한강진역 2번 출구 앞 대여소&eName=한남초교 앞 보도육교 대여소&target=bicycle
921,951,177,42,2070,1183,135,887,2,0.616438356,신도고등학교,연신내역 6번출구옆,http://map.daum.net/?sName=신도고등학교 대여소&eName=연신내역 6번출구옆 대여소&target=bicycle
905,951,205,128,8088,11050,77,-2962,1,0.231231231,구파발역 2번출구,연신내역 6번출구옆,http://map.daum.net/?sName=구파발역 2번출구 대여소&eName=연신내역 6번출구옆 대여소&target=bicycle
931,951,80,249,8421,10731,-169,-2310,3,0.513677812,역촌파출소,연신내역 6번출구옆,http://map.daum.net/?sName=역촌파출소 대여소&eName=연신내역 6번출구옆 대여소&target=bicycle
907,951,97,184,17334,21700,-87,-4366,1,0.309608541,CJ 드림시티,연신내역 6번출구옆,http://map.daum.net/?sName=CJ 드림시티 대여소&eName=연신내역 6번출구옆 대여소&target=bicycle
415,416,83,349,11826,9532,-266,2294,5,0.615740741,DMC역 9번출구 앞,상암월드컵파크 1단지 교차로,http://map.daum.net/?sName=DMC역 9번출구 앞 대여소&eName=상암월드컵파크 1단지 교차로 대여소&target=bicycle
415,907,226,60,11826,9532,166,2294,3,0.58041958,DMC역 9번출구 앞,CJ 드림시티,http://map.daum.net/?sName=DMC역 9번출구 앞 대여소&eName=CJ 드림시티 대여소&target=bicycle
900,907,394,167,3252,3085,227,167,4,0.404634581,은평예술회관,CJ 드림시티,http://map.daum.net/?sName=은평예술회관 대여소&eName=CJ 드림시티 대여소&target=bicycle
901,907,622,397,4032,4189,225,-157,4,0.220804711,응암1동사무소,CJ 드림시티,http://map.daum.net/?sName=응암1동사무소 대여소&eName=CJ 드림시티 대여소&target=bicycle
102,907,142,58,14864,13529,84,1335,1,0.42,망원역 1번출구 앞,CJ 드림시티,http://map.daum.net/?sName=망원역 1번출구 앞 대여소&eName=CJ 드림시티 대여소&target=bicycle
417,907,302,126,8832,6175,176,2657,3,0.411214953,DMC역 2번출구 옆,CJ 드림시티,http://map.daum.net/?sName=DMC역 2번출구 옆 대여소&eName=CJ 드림시티 대여소&target=bicycle
176,907,154,67,8730,9930,87,-1200,1,0.393665158,명지대학교 도서관,CJ 드림시티,http://map.daum.net/?sName=명지대학교 도서관 대여소&eName=CJ 드림시티 대여소&target=bicycle
409,907,147,267,11080,13610,-120,-2530,2,0.289855072,누리꿈스퀘어 옆,CJ 드림시티,http://map.daum.net/?sName=누리꿈스퀘어 옆 대여소&eName=CJ 드림시티 대여소&target=bicycle
415,914,309,195,11826,9532,114,2294,2,0.226190476,DMC역 9번출구 앞,새절역 2번출구,http://map.daum.net/?sName=DMC역 9번출구 앞 대여소&eName=새절역 2번출구 대여소&target=bicycle
417,914,249,123,8832,6175,126,2657,2,0.338709677,DMC역 2번출구 옆,새절역 2번출구,http://map.daum.net/?sName=DMC역 2번출구 옆 대여소&eName=새절역 2번출구 대여소&target=bicycle
409,914,106,207,11080,13610,-101,-2530,2,0.322683706,누리꿈스퀘어 옆,새절역 2번출구,http://map.daum.net/?sName=누리꿈스퀘어 옆 대여소&eName=새절역 2번출구 대여소&target=bicycle
153,914,101,153,11604,12172,-52,-568,1,0.204724409,성산2교 사거리,새절역 2번출구,http://map.daum.net/?sName=성산2교 사거리 대여소&eName=새절역 2번출구 대여소&target=bicycle
412,914,115,199,8179,8505,-84,-326,1,0.267515924,DMC산학협력연구센터 앞,새절역 2번출구,http://map.daum.net/?sName=DMC산학협력연구센터 앞 대여소&eName=새절역 2번출구 대여소&target=bicycle
194,914,314,203,8218,8418,111,-200,2,0.214700193,증산교 앞,새절역 2번출구,http://map.daum.net/?sName=증산교 앞 대여소&eName=새절역 2번출구 대여소&target=bicycle
421,914,215,126,15379,17398,89,-2019,1,0.260997067,마포구청 앞,새절역 2번출구,http://map.daum.net/?sName=마포구청 앞 대여소&eName=새절역 2번출구 대여소&target=bicycle
114,176,322,77,13563,13818,245,-255,4,0.614035088,홍대입구역 8번출구 앞,명지대학교 도서관,http://map.daum.net/?sName=홍대입구역 8번출구 앞 대여소&eName=명지대학교 도서관 대여소&target=bicycle
110,176,130,78,4254,3058,52,1196,1,0.25,사천교,명지대학교 도서관,http://map.daum.net/?sName=사천교 대여소&eName=명지대학교 도서관 대여소&target=bicycle
115,176,142,64,8254,7077,78,1177,1,0.378640777,사루비아 빌딩 앞,명지대학교 도서관,http://map.daum.net/?sName=사루비아 빌딩 앞 대여소&eName=명지대학교 도서관 대여소&target=bicycle
107,176,85,137,12206,14037,-52,-1831,1,0.234234234,신한은행 서교동금융센터점 앞,명지대학교 도서관,http://map.daum.net/?sName=신한은행 서교동금융센터점 앞 대여소&eName=명지대학교 도서관 대여소&target=bicycle
168,176,143,93,2274,1469,50,805,1,0.211864407,남가좌동 사거리,명지대학교 도서관,http://map.daum.net/?sName=남가좌동 사거리 대여소&eName=명지대학교 도서관 대여소&target=bicycle
114,155,187,52,13563,13818,135,-255,2,0.564853556,홍대입구역 8번출구 앞,가좌역1 번출구 뒤,http://map.daum.net/?sName=홍대입구역 8번출구 앞 대여소&eName=가좌역1 번출구 뒤 대여소&target=bicycle
114,150,115,238,13563,13818,-123,-255,2,0.348441926,홍대입구역 8번출구 앞,서강대역 2번출구 앞,http://map.daum.net/?sName=홍대입구역 8번출구 앞 대여소&eName=서강대역 2번출구 앞 대여소&target=bicycle
146,150,90,142,10914,11574,-52,-660,1,0.224137931,마포역 1번출구 뒤,서강대역 2번출구 앞,http://map.daum.net/?sName=마포역 1번출구 뒤 대여소&eName=서강대역 2번출구 앞 대여소&target=bicycle
114,183,520,256,13563,13818,264,-255,5,0.340206186,홍대입구역 8번출구 앞,하늘채코오롱아파트 건너편,http://map.daum.net/?sName=홍대입구역 8번출구 앞 대여소&eName=하늘채코오롱아파트 건너편 대여소&target=bicycle
166,183,88,196,8122,8785,-108,-663,2,0.38028169,가재울 초등학교,하늘채코오롱아파트 건너편,http://map.daum.net/?sName=가재울 초등학교 대여소&eName=하늘채코오롱아파트 건너편 대여소&target=bicycle
176,183,157,336,8730,9930,-179,-1200,3,0.363083164,명지대학교 도서관,하늘채코오롱아파트 건너편,http://map.daum.net/?sName=명지대학교 도서관 대여소&eName=하늘채코오롱아파트 건너편 대여소&target=bicycle
106,183,164,88,17613,16584,76,1029,1,0.301587302,합정역 7번출구 앞,하늘채코오롱아파트 건너편,http://map.daum.net/?sName=합정역 7번출구 앞 대여소&eName=하늘채코오롱아파트 건너편 대여소&target=bicycle
170,183,158,282,5904,6518,-124,-614,2,0.281818182,가재울 뉴타운 주유소 옆,하늘채코오롱아파트 건너편,http://map.daum.net/?sName=가재울 뉴타운 주유소 옆 대여소&eName=하늘채코오롱아파트 건너편 대여소&target=bicycle
164,183,74,131,2998,2589,-57,409,1,0.27804878,북가좌1동 주민센터,하늘채코오롱아파트 건너편,http://map.daum.net/?sName=북가좌1동 주민센터 대여소&eName=하늘채코오롱아파트 건너편 대여소&target=bicycle
114,125,92,170,13563,13818,-78,-255,1,0.297709924,홍대입구역 8번출구 앞,서강대 남문 옆,http://map.daum.net/?sName=홍대입구역 8번출구 앞 대여소&eName=서강대 남문 옆 대여소&target=bicycle
114,152,205,111,13563,13818,94,-255,1,0.297468354,홍대입구역 8번출구 앞,마포구민체육센터 앞,http://map.daum.net/?sName=홍대입구역 8번출구 앞 대여소&eName=마포구민체육센터 앞 대여소&target=bicycle
115,152,171,71,8254,7077,100,1177,2,0.41322314,사루비아 빌딩 앞,마포구민체육센터 앞,http://map.daum.net/?sName=사루비아 빌딩 앞 대여소&eName=마포구민체육센터 앞 대여소&target=bicycle
108,152,226,149,8583,8757,77,-174,1,0.205333333,서교동 사거리,마포구민체육센터 앞,http://map.daum.net/?sName=서교동 사거리 대여소&eName=마포구민체육센터 앞 대여소&target=bicycle
109,152,263,159,9528,9202,104,326,2,0.246445498,제일빌딩 앞,마포구민체육센터 앞,http://map.daum.net/?sName=제일빌딩 앞 대여소&eName=마포구민체육센터 앞 대여소&target=bicycle
112,152,162,105,8678,8465,57,213,1,0.213483146,극동방송국 앞,마포구민체육센터 앞,http://map.daum.net/?sName=극동방송국 앞 대여소&eName=마포구민체육센터 앞 대여소&target=bicycle
114,116,334,200,13563,13818,134,-255,2,0.25093633,홍대입구역 8번출구 앞,일진아이윌아파트 옆,http://map.daum.net/?sName=홍대입구역 8번출구 앞 대여소&eName=일진아이윌아파트 옆 대여소&target=bicycle
115,116,249,147,8254,7077,102,1177,2,0.257575758,사루비아 빌딩 앞,일진아이윌아파트 옆,http://map.daum.net/?sName=사루비아 빌딩 앞 대여소&eName=일진아이윌아파트 옆 대여소&target=bicycle
106,116,151,84,17613,16584,67,1029,1,0.285106383,합정역 7번출구 앞,일진아이윌아파트 옆,http://map.daum.net/?sName=합정역 7번출구 앞 대여소&eName=일진아이윌아파트 옆 대여소&target=bicycle
103,116,231,117,10248,9142,114,1106,2,0.327586207,망원역 2번출구 앞,일진아이윌아파트 옆,http://map.daum.net/?sName=망원역 2번출구 앞 대여소&eName=일진아이윌아파트 옆 대여소&target=bicycle
114,184,175,106,13563,13818,69,-255,1,0.245551601,홍대입구역 8번출구 앞,SK망원동주유소 건너편,http://map.daum.net/?sName=홍대입구역 8번출구 앞 대여소&eName=SK망원동주유소 건너편 대여소&target=bicycle
106,184,239,138,17613,16584,101,1029,2,0.267904509,합정역 7번출구 앞,SK망원동주유소 건너편,http://map.daum.net/?sName=합정역 7번출구 앞 대여소&eName=SK망원동주유소 건너편 대여소&target=bicycle
103,184,264,162,10248,9142,102,1106,2,0.23943662,망원역 2번출구 앞,SK망원동주유소 건너편,http://map.daum.net/?sName=망원역 2번출구 앞 대여소&eName=SK망원동주유소 건너편 대여소&target=bicycle
114,151,161,98,13563,13818,63,-255,1,0.243243243,홍대입구역 8번출구 앞,망원1동주민센터,http://map.daum.net/?sName=홍대입구역 8번출구 앞 대여소&eName=망원1동주민센터 대여소&target=bicycle
106,151,467,259,17613,16584,208,1029,4,0.286501377,합정역 7번출구 앞,망원1동주민센터,http://map.daum.net/?sName=합정역 7번출구 앞 대여소&eName=망원1동주민센터 대여소&target=bicycle
114,195,146,90,13563,13818,56,-255,1,0.237288136,홍대입구역 8번출구 앞,모래내고가차도,http://map.daum.net/?sName=홍대입구역 8번출구 앞 대여소&eName=모래내고가차도 대여소&target=bicycle
183,195,81,247,15895,15355,-166,540,3,0.506097561,하늘채코오롱아파트 건너편,모래내고가차도,http://map.daum.net/?sName=하늘채코오롱아파트 건너편 대여소&eName=모래내고가차도 대여소&target=bicycle
114,126,113,183,13563,13818,-70,-255,1,0.236486486,홍대입구역 8번출구 앞,서강대 후문 옆,http://map.daum.net/?sName=홍대입구역 8번출구 앞 대여소&eName=서강대 후문 옆 대여소&target=bicycle
114,124,149,241,13563,13818,-92,-255,1,0.235897436,홍대입구역 8번출구 앞,서강대 정문 건너편,http://map.daum.net/?sName=홍대입구역 8번출구 앞 대여소&eName=서강대 정문 건너편 대여소&target=bicycle
118,124,128,203,7742,7577,-75,165,1,0.226586103,광흥창역 2번출구 앞,서강대 정문 건너편,http://map.daum.net/?sName=광흥창역 2번출구 앞 대여소&eName=서강대 정문 건너편 대여소&target=bicycle
1906,708,296,71,20295,19621,225,674,4,0.613079019,신도림역 1번 출구 앞,서울출입국관리사무소 앞,http://map.daum.net/?sName=신도림역 1번 출구 앞 대여소&eName=서울출입국관리사무소 앞 대여소&target=bicycle
1906,1931,223,71,20295,19621,152,674,3,0.517006803,신도림역 1번 출구 앞,개봉역(북측광장),http://map.daum.net/?sName=신도림역 1번 출구 앞 대여소&eName=개봉역(북측광장) 대여소&target=bicycle
1906,716,152,59,20295,19621,93,674,1,0.440758294,신도림역 1번 출구 앞,신정6동 주민센터 인근,http://map.daum.net/?sName=신도림역 1번 출구 앞 대여소&eName=신정6동 주민센터 인근 대여소&target=bicycle
1906,1933,215,87,20295,19621,128,674,2,0.42384106,신도림역 1번 출구 앞,개봉푸르지오아파트 상가,http://map.daum.net/?sName=신도림역 1번 출구 앞 대여소&eName=개봉푸르지오아파트 상가 대여소&target=bicycle
1929,1933,146,69,3135,2989,77,146,1,0.358139535,고척근린공원 고척도서관 앞,개봉푸르지오아파트 상가,http://map.daum.net/?sName=고척근린공원 고척도서관 앞 대여소&eName=개봉푸르지오아파트 상가 대여소&target=bicycle
1906,1966,219,91,20295,19621,128,674,2,0.412903226,신도림역 1번 출구 앞,한마을아파트 정문상가,http://map.daum.net/?sName=신도림역 1번 출구 앞 대여소&eName=한마을아파트 정문상가 대여소&target=bicycle
1908,1966,114,210,8098,8670,-96,-572,1,0.296296296,해원리바파크 육교 밑,한마을아파트 정문상가,http://map.daum.net/?sName=해원리바파크 육교 밑 대여소&eName=한마을아파트 정문상가 대여소&target=bicycle
1906,1928,207,95,20295,19621,112,674,2,0.370860927,신도림역 1번 출구 앞,고척스카이돔구장 광장,http://map.daum.net/?sName=신도림역 1번 출구 앞 대여소&eName=고척스카이돔구장 광장 대여소&target=bicycle
1907,1928,75,132,2640,2650,-57,-10,1,0.275362319,구일우성(아) 육교 밑,고척스카이돔구장 광장,http://map.daum.net/?sName=구일우성(아) 육교 밑 대여소&eName=고척스카이돔구장 광장 대여소&target=bicycle
1906,262,124,225,20295,19621,-101,674,2,0.289398281,신도림역 1번 출구 앞,영문초등학교 사거리,http://map.daum.net/?sName=신도림역 1번 출구 앞 대여소&eName=영문초등학교 사거리 대여소&target=bicycle
1906,272,128,78,20295,19621,50,674,1,0.242718447,신도림역 1번 출구 앞,당산육갑문,http://map.daum.net/?sName=신도림역 1번 출구 앞 대여소&eName=당산육갑문 대여소&target=bicycle
227,272,290,485,6651,8339,-195,-1688,3,0.251612903,양평2나들목 보행통로 입구,당산육갑문,http://map.daum.net/?sName=양평2나들목 보행통로 입구 대여소&eName=당산육갑문 대여소&target=bicycle
238,272,82,168,8430,8601,-86,-171,1,0.344,제2구민체육센타 앞,당산육갑문,http://map.daum.net/?sName=제2구민체육센타 앞 대여소&eName=당산육갑문 대여소&target=bicycle
247,272,615,274,16564,15920,341,644,6,0.383577053,당산역 10번출구 앞,당산육갑문,http://map.daum.net/?sName=당산역 10번출구 앞 대여소&eName=당산육갑문 대여소&target=bicycle
106,272,125,192,17613,16584,-67,1029,1,0.211356467,합정역 7번출구 앞,당산육갑문,http://map.daum.net/?sName=합정역 7번출구 앞 대여소&eName=당산육갑문 대여소&target=bicycle
1123,272,109,171,6092,6468,-62,-376,1,0.221428571,공암나루근린공원 관리사무소옆,당산육갑문,http://map.daum.net/?sName=공암나루근린공원 관리사무소옆 대여소&eName=당산육갑문 대여소&target=bicycle
267,272,154,87,5964,5464,67,500,1,0.278008299,삼성화재 사옥 옆,당산육갑문,http://map.daum.net/?sName=삼성화재 사옥 옆 대여소&eName=당산육갑문 대여소&target=bicycle
1158,272,93,161,13756,14373,-68,-617,1,0.267716535,가양역 8번출구,당산육갑문,http://map.daum.net/?sName=가양역 8번출구 대여소&eName=당산육갑문 대여소&target=bicycle
245,272,154,97,7642,7836,57,-194,1,0.227091633,삼성생명 당산사옥 앞,당산육갑문,http://map.daum.net/?sName=삼성생명 당산사옥 앞 대여소&eName=당산육갑문 대여소&target=bicycle
1906,241,132,215,20295,19621,-83,674,1,0.239193084,신도림역 1번 출구 앞,신길우성1차아파트 앞 공원,http://map.daum.net/?sName=신도림역 1번 출구 앞 대여소&eName=신길우성1차아파트 앞 공원 대여소&target=bicycle
1906,1925,771,482,20295,19621,289,674,5,0.230646449,신도림역 1번 출구 앞,동양미래대학교 정문 옆,http://map.daum.net/?sName=신도림역 1번 출구 앞 대여소&eName=동양미래대학교 정문 옆 대여소&target=bicycle
1906,1961,84,134,20295,19621,-50,674,1,0.229357798,신도림역 1번 출구 앞,신도림테크노근린공원,http://map.daum.net/?sName=신도림역 1번 출구 앞 대여소&eName=신도림테크노근린공원 대여소&target=bicycle
712,733,50,206,1864,2740,-156,-876,3,0.609375,강월초교입구 사거리,신정이펜하우스314동,http://map.daum.net/?sName=강월초교입구 사거리 대여소&eName=신정이펜하우스314동 대여소&target=bicycle
706,733,101,201,3416,4233,-100,-817,2,0.331125828,신정네거리역,신정이펜하우스314동,http://map.daum.net/?sName=신정네거리역 대여소&eName=신정이펜하우스314동 대여소&target=bicycle
710,733,118,260,1956,2030,-142,-74,2,0.375661376,서부화물트럭터미널 사거리,신정이펜하우스314동,http://map.daum.net/?sName=서부화물트럭터미널 사거리 대여소&eName=신정이펜하우스314동 대여소&target=bicycle
305,307,52,214,7458,7793,-162,-335,3,0.609022556,종로구청 옆,서울역사박물관 앞,http://map.daum.net/?sName=종로구청 옆 대여소&eName=서울역사박물관 앞 대여소&target=bicycle
305,354,79,186,7458,7793,-107,-335,2,0.403773585,종로구청 옆,포르투갈 대사관 앞,http://map.daum.net/?sName=종로구청 옆 대여소&eName=포르투갈 대사관 앞 대여소&target=bicycle
327,354,164,284,7393,6943,-120,450,2,0.267857143,낙원상가 옆,포르투갈 대사관 앞,http://map.daum.net/?sName=낙원상가 옆 대여소&eName=포르투갈 대사관 앞 대여소&target=bicycle
338,354,70,143,7569,6962,-73,607,1,0.342723005,세운스퀘어 앞,포르투갈 대사관 앞,http://map.daum.net/?sName=세운스퀘어 앞 대여소&eName=포르투갈 대사관 앞 대여소&target=bicycle
351,354,142,84,4211,4023,58,188,1,0.256637168,청운초교 앞 삼거리,포르투갈 대사관 앞,http://map.daum.net/?sName=청운초교 앞 삼거리 대여소&eName=포르투갈 대사관 앞 대여소&target=bicycle
305,349,117,194,7458,7793,-77,-335,1,0.247588424,종로구청 옆,사직동주민센터,http://map.daum.net/?sName=종로구청 옆 대여소&eName=사직동주민센터 대여소&target=bicycle
306,349,106,185,6507,5357,-79,1150,1,0.271477663,광화문역 7번출구 앞,사직동주민센터,http://map.daum.net/?sName=광화문역 7번출구 앞 대여소&eName=사직동주민센터 대여소&target=bicycle
304,349,96,160,5979,5598,-64,381,1,0.25,광화문역 2번출구 앞,사직동주민센터,http://map.daum.net/?sName=광화문역 2번출구 앞 대여소&eName=사직동주민센터 대여소&target=bicycle
2020,2058,329,80,3006,2470,249,536,4,0.608801956,장승배기역2번출구뒷편쪽,노량진동 맥도널드앞,http://map.daum.net/?sName=장승배기역2번출구뒷편쪽 대여소&eName=노량진동 맥도널드앞 대여소&target=bicycle
2013,2058,961,478,10096,7475,483,2621,9,0.335649757,장승배기역 5번출구,노량진동 맥도널드앞,http://map.daum.net/?sName=장승배기역 5번출구 대여소&eName=노량진동 맥도널드앞 대여소&target=bicycle
2057,2058,198,70,2184,1355,128,829,2,0.47761194,상도 아이파크 아파트,노량진동 맥도널드앞,http://map.daum.net/?sName=상도 아이파크 아파트 대여소&eName=노량진동 맥도널드앞 대여소&target=bicycle
2020,2050,433,149,3006,2470,284,536,5,0.487972509,장승배기역2번출구뒷편쪽,노량진역 5번출구,http://map.daum.net/?sName=장승배기역2번출구뒷편쪽 대여소&eName=노량진역 5번출구 대여소&target=bicycle
2013,2050,2994,993,10096,7475,2001,2621,40,0.501881114,장승배기역 5번출구,노량진역 5번출구,http://map.daum.net/?sName=장승배기역 5번출구 대여소&eName=노량진역 5번출구 대여소&target=bicycle
1302,1304,46,189,3900,3877,-143,23,2,0.608510638,한성대입구역6번출구 뒤,만해공원,http://map.daum.net/?sName=한성대입구역6번출구 뒤 대여소&eName=만해공원 대여소&target=bicycle
1302,1342,73,177,3900,3877,-104,23,2,0.416,한성대입구역6번출구 뒤,성북쉼터 앞,http://map.daum.net/?sName=한성대입구역6번출구 뒤 대여소&eName=성북쉼터 앞 대여소&target=bicycle
1302,1337,145,80,3900,3877,65,23,1,0.288888889,한성대입구역6번출구 뒤,돈암성당 옆,http://map.daum.net/?sName=한성대입구역6번출구 뒤 대여소&eName=돈암성당 옆 대여소&target=bicycle
2102,2136,69,279,26561,26904,-210,-343,4,0.603448276,봉림교 교통섬,신림역 8번출구,http://map.daum.net/?sName=봉림교 교통섬 대여소&eName=신림역 8번출구 대여소&target=bicycle
2111,2136,152,66,4549,4296,86,253,1,0.394495413,서울대입구역 1번출구,신림역 8번출구,http://map.daum.net/?sName=서울대입구역 1번출구 대여소&eName=신림역 8번출구 대여소&target=bicycle
2102,2135,126,331,26561,26904,-205,-343,4,0.448577681,봉림교 교통섬,신림역 5번출구,http://map.daum.net/?sName=봉림교 교통섬 대여소&eName=신림역 5번출구 대여소&target=bicycle
2106,2135,146,252,4513,6078,-106,-1565,2,0.266331658,난곡 새마을금고,신림역 5번출구,http://map.daum.net/?sName=난곡 새마을금고 대여소&eName=신림역 5번출구 대여소&target=bicycle
2102,2171,84,200,26561,26904,-116,-343,2,0.408450704,봉림교 교통섬,서울대입구역 5번출구,http://map.daum.net/?sName=봉림교 교통섬 대여소&eName=서울대입구역 5번출구 대여소&target=bicycle
2109,2171,249,377,6258,7811,-128,-1553,2,0.204472843,은천로입구 가로공원,서울대입구역 5번출구,http://map.daum.net/?sName=은천로입구 가로공원 대여소&eName=서울대입구역 5번출구 대여소&target=bicycle
2119,2171,218,113,4150,3982,105,168,2,0.317220544,중앙동 동진빌딩,서울대입구역 5번출구,http://map.daum.net/?sName=중앙동 동진빌딩 대여소&eName=서울대입구역 5번출구 대여소&target=bicycle
2108,2171,276,441,5185,5464,-165,-279,3,0.230125523,은천치안센터,서울대입구역 5번출구,http://map.daum.net/?sName=은천치안센터 대여소&eName=서울대입구역 5번출구 대여소&target=bicycle
2136,2171,243,373,7092,7283,-130,-191,2,0.211038961,신림역 8번출구,서울대입구역 5번출구,http://map.daum.net/?sName=신림역 8번출구 대여소&eName=서울대입구역 5번출구 대여소&target=bicycle
2164,2171,127,205,3614,3612,-78,2,1,0.234939759,관악우체국,서울대입구역 5번출구,http://map.daum.net/?sName=관악우체국 대여소&eName=서울대입구역 5번출구 대여소&target=bicycle
2102,2110,92,173,26561,26904,-81,-343,1,0.305660377,봉림교 교통섬,조원동 미성아파트,http://map.daum.net/?sName=봉림교 교통섬 대여소&eName=조원동 미성아파트 대여소&target=bicycle
2102,2106,705,429,26561,26904,276,-343,5,0.243386243,봉림교 교통섬,난곡 새마을금고,http://map.daum.net/?sName=봉림교 교통섬 대여소&eName=난곡 새마을금고 대여소&target=bicycle
1955,2106,174,115,8237,8018,59,219,1,0.204152249,디지털입구 교차로,난곡 새마을금고,http://map.daum.net/?sName=디지털입구 교차로 대여소&eName=난곡 새마을금고 대여소&target=bicycle
2105,2106,442,289,2425,2418,153,7,3,0.209302326,미성동 신림체육센터,난곡 새마을금고,http://map.daum.net/?sName=미성동 신림체육센터 대여소&eName=난곡 새마을금고 대여소&target=bicycle
2102,2115,156,96,26561,26904,60,-343,1,0.238095238,봉림교 교통섬,관악농협농산물백화점,http://map.daum.net/?sName=봉림교 교통섬 대여소&eName=관악농협농산물백화점 대여소&target=bicycle
1911,2115,340,517,14800,15147,-177,-347,3,0.206534422,구로디지털단지역 앞,관악농협농산물백화점,http://map.daum.net/?sName=구로디지털단지역 앞 대여소&eName=관악농협농산물백화점 대여소&target=bicycle
2110,2115,172,289,3053,2824,-117,229,2,0.253796095,조원동 미성아파트,관악농협농산물백화점,http://map.daum.net/?sName=조원동 미성아파트 대여소&eName=관악농협농산물백화점 대여소&target=bicycle
2102,2156,289,191,26561,26904,98,-343,1,0.204166667,봉림교 교통섬,농협 관악문성지점,http://map.daum.net/?sName=봉림교 교통섬 대여소&eName=농협 관악문성지점 대여소&target=bicycle
1911,2156,138,284,14800,15147,-146,-347,2,0.345971564,구로디지털단지역 앞,농협 관악문성지점,http://map.daum.net/?sName=구로디지털단지역 앞 대여소&eName=농협 관악문성지점 대여소&target=bicycle
2106,2156,88,211,4513,6078,-123,-1565,2,0.411371237,난곡 새마을금고,농협 관악문성지점,http://map.daum.net/?sName=난곡 새마을금고 대여소&eName=농협 관악문성지점 대여소&target=bicycle
905,945,239,943,8088,11050,-704,-2962,14,0.595600677,구파발역 2번출구,기자촌 사거리,http://map.daum.net/?sName=구파발역 2번출구 대여소&eName=기자촌 사거리 대여소&target=bicycle
905,941,613,1539,8088,11050,-926,-2962,18,0.430297398,구파발역 2번출구,은평뉴타운 도서관,http://map.daum.net/?sName=구파발역 2번출구 대여소&eName=은평뉴타운 도서관 대여소&target=bicycle
905,924,99,246,8088,11050,-147,-2962,2,0.426086957,구파발역 2번출구,메뚜기다리,http://map.daum.net/?sName=구파발역 2번출구 대여소&eName=메뚜기다리 대여소&target=bicycle
905,921,140,296,8088,11050,-156,-2962,3,0.357798165,구파발역 2번출구,신도고등학교,http://map.daum.net/?sName=구파발역 2번출구 대여소&eName=신도고등학교 대여소&target=bicycle
905,928,128,240,8088,11050,-112,-2962,2,0.304347826,구파발역 2번출구,은평역사한옥박물관,http://map.daum.net/?sName=구파발역 2번출구 대여소&eName=은평역사한옥박물관 대여소&target=bicycle
1008,1014,63,238,8222,10784,-175,-2562,3,0.581395349,암사역 3번출구(국민은행앞),강동구평생학습관앞,http://map.daum.net/?sName=암사역 3번출구(국민은행앞) 대여소&eName=강동구평생학습관앞 대여소&target=bicycle
1004,1014,59,222,4513,6431,-163,-1918,3,0.580071174,삼성광나루아파트 버스정류장,강동구평생학습관앞,http://map.daum.net/?sName=삼성광나루아파트 버스정류장 대여소&eName=강동구평생학습관앞 대여소&target=bicycle
1001,1014,96,176,6934,7075,-80,-141,1,0.294117647,광진교 남단 사거리(디지털프라자앞),강동구평생학습관앞,http://map.daum.net/?sName=광진교 남단 사거리(디지털프라자앞) 대여소&eName=강동구평생학습관앞 대여소&target=bicycle
1010,1014,96,195,7685,7616,-99,69,1,0.340206186,강동세무서,강동구평생학습관앞,http://map.daum.net/?sName=강동세무서 대여소&eName=강동구평생학습관앞 대여소&target=bicycle
1009,1014,140,88,12114,11462,52,652,1,0.228070175,천호역4번출구(현대백화점),강동구평생학습관앞,http://map.daum.net/?sName=천호역4번출구(현대백화점) 대여소&eName=강동구평생학습관앞 대여소&target=bicycle
1008,1012,80,159,8222,10784,-79,-2562,1,0.330543933,암사역 3번출구(국민은행앞),서울 상운차량,http://map.daum.net/?sName=암사역 3번출구(국민은행앞) 대여소&eName=서울 상운차량 대여소&target=bicycle
1008,1044,137,245,8222,10784,-108,-2562,2,0.282722513,암사역 3번출구(국민은행앞),굽은다리역,http://map.daum.net/?sName=암사역 3번출구(국민은행앞) 대여소&eName=굽은다리역 대여소&target=bicycle
1029,1044,148,80,6247,6417,68,-170,1,0.298245614,롯데 시네마,굽은다리역,http://map.daum.net/?sName=롯데 시네마 대여소&eName=굽은다리역 대여소&target=bicycle
1033,1044,191,112,3111,2705,79,406,1,0.260726073,고덕동 아남아파트,굽은다리역,http://map.daum.net/?sName=고덕동 아남아파트 대여소&eName=굽은다리역 대여소&target=bicycle
1027,1044,135,84,2484,2711,51,-227,1,0.232876712,프라자 아파트 앞,굽은다리역,http://map.daum.net/?sName=프라자 아파트 앞 대여소&eName=굽은다리역 대여소&target=bicycle
1008,1264,150,251,8222,10784,-101,-2562,2,0.251870324,암사역 3번출구(국민은행앞),천호역 10번 출구 앞,http://map.daum.net/?sName=암사역 3번출구(국민은행앞) 대여소&eName=천호역 10번 출구 앞 대여소&target=bicycle
1028,1264,197,103,2881,2855,94,26,1,0.313333333,포레스 주상복합 빌딩,천호역 10번 출구 앞,http://map.daum.net/?sName=포레스 주상복합 빌딩 대여소&eName=천호역 10번 출구 앞 대여소&target=bicycle
1011,1264,90,154,10393,10422,-64,-29,1,0.262295082,LIGA 아파트 앞,천호역 10번 출구 앞,http://map.daum.net/?sName=LIGA 아파트 앞 대여소&eName=천호역 10번 출구 앞 대여소&target=bicycle
1008,1010,108,164,8222,10784,-56,-2562,1,0.205882353,암사역 3번출구(국민은행앞),강동세무서,http://map.daum.net/?sName=암사역 3번출구(국민은행앞) 대여소&eName=강동세무서 대여소&target=bicycle
1004,1051,119,234,4513,6431,-115,-1918,2,0.325779037,삼성광나루아파트 버스정류장,양지시장 (용성약국앞) 입구,http://map.daum.net/?sName=삼성광나루아파트 버스정류장 대여소&eName=양지시장 (용성약국앞) 입구 대여소&target=bicycle
1001,1051,217,133,6934,7075,84,-141,1,0.24,광진교 남단 사거리(디지털프라자앞),양지시장 (용성약국앞) 입구,http://map.daum.net/?sName=광진교 남단 사거리(디지털프라자앞) 대여소&eName=양지시장 (용성약국앞) 입구 대여소&target=bicycle
1014,1051,185,90,4169,3409,95,760,1,0.345454545,강동구평생학습관앞,양지시장 (용성약국앞) 입구,http://map.daum.net/?sName=강동구평생학습관앞 대여소&eName=양지시장 (용성약국앞) 입구 대여소&target=bicycle
1004,1033,123,197,4513,6431,-74,-1918,1,0.23125,삼성광나루아파트 버스정류장,고덕동 아남아파트,http://map.daum.net/?sName=삼성광나루아파트 버스정류장 대여소&eName=고덕동 아남아파트 대여소&target=bicycle
1004,1009,290,455,4513,6431,-165,-1918,3,0.22147651,삼성광나루아파트 버스정류장,천호역4번출구(현대백화점),http://map.daum.net/?sName=삼성광나루아파트 버스정류장 대여소&eName=천호역4번출구(현대백화점) 대여소&target=bicycle
2353,2365,184,49,3242,2000,135,1242,2,0.579399142,강남구청역 2번출구 뒤,K+ 타워 앞,http://map.daum.net/?sName=강남구청역 2번출구 뒤 대여소&eName=K+ 타워 앞 대여소&target=bicycle
302,446,165,44,11460,10788,121,672,2,0.578947368,경복궁역 4번출구 뒤,상명대입구,http://map.daum.net/?sName=경복궁역 4번출구 뒤 대여소&eName=상명대입구 대여소&target=bicycle
117,446,208,344,10247,10327,-136,-80,2,0.246376812,홍은사거리,상명대입구,http://map.daum.net/?sName=홍은사거리 대여소&eName=상명대입구 대여소&target=bicycle
123,446,145,356,3813,4323,-211,-510,4,0.421157685,문화촌 공원,상명대입구,http://map.daum.net/?sName=문화촌 공원 대여소&eName=상명대입구 대여소&target=bicycle
302,310,161,95,11460,10788,66,672,1,0.2578125,경복궁역 4번출구 뒤,청계광장 옆,http://map.daum.net/?sName=경복궁역 4번출구 뒤 대여소&eName=청계광장 옆 대여소&target=bicycle
300,310,162,67,6116,5344,95,772,1,0.414847162,정동사거리,청계광장 옆,http://map.daum.net/?sName=정동사거리 대여소&eName=청계광장 옆 대여소&target=bicycle
303,310,89,147,8375,7554,-58,821,1,0.245762712,광화문역 1번출구 앞,청계광장 옆,http://map.daum.net/?sName=광화문역 1번출구 앞 대여소&eName=청계광장 옆 대여소&target=bicycle
207,225,43,160,48130,45467,-117,2663,2,0.57635468,여의나루역 1번출구 앞,앙카라공원 앞,http://map.daum.net/?sName=여의나루역 1번출구 앞 대여소&eName=앙카라공원 앞 대여소&target=bicycle
224,225,71,169,8285,7962,-98,323,1,0.408333333,롯데캐슬 앞,앙카라공원 앞,http://map.daum.net/?sName=롯데캐슬 앞 대여소&eName=앙카라공원 앞 대여소&target=bicycle
221,225,283,515,7796,8567,-232,-771,4,0.290726817,여의도초교 앞,앙카라공원 앞,http://map.daum.net/?sName=여의도초교 앞 대여소&eName=앙카라공원 앞 대여소&target=bicycle
223,225,341,649,6759,6451,-308,308,6,0.311111111,진주아파트상가 앞,앙카라공원 앞,http://map.daum.net/?sName=진주아파트상가 앞 대여소&eName=앙카라공원 앞 대여소&target=bicycle
207,2102,78,190,48130,45467,-112,2663,2,0.417910448,여의나루역 1번출구 앞,봉림교 교통섬,http://map.daum.net/?sName=여의나루역 1번출구 앞 대여소&eName=봉림교 교통섬 대여소&target=bicycle
1955,2102,256,154,8237,8018,102,219,2,0.248780488,디지털입구 교차로,봉림교 교통섬,http://map.daum.net/?sName=디지털입구 교차로 대여소&eName=봉림교 교통섬 대여소&target=bicycle
207,2214,147,61,48130,45467,86,2663,1,0.413461538,여의나루역 1번출구 앞,신반포역 2번출구 앞,http://map.daum.net/?sName=여의나루역 1번출구 앞 대여소&eName=신반포역 2번출구 앞 대여소&target=bicycle
207,249,764,343,48130,45467,421,2663,8,0.380307136,여의나루역 1번출구 앞,여의도중학교 옆,http://map.daum.net/?sName=여의나루역 1번출구 앞 대여소&eName=여의도중학교 옆 대여소&target=bicycle
215,249,140,61,5285,6023,79,-738,1,0.393034826,여의도고교 앞,여의도중학교 옆,http://map.daum.net/?sName=여의도고교 앞 대여소&eName=여의도중학교 옆 대여소&target=bicycle
2219,249,174,79,26414,27015,95,-601,1,0.375494071,"고속터미널역 8-1번, 8-2번 출구 사이",여의도중학교 옆,"http://map.daum.net/?sName=고속터미널역 8-1번, 8-2번 출구 사이 대여소&eName=여의도중학교 옆 대여소&target=bicycle"
207,220,94,209,48130,45467,-115,2663,2,0.379537954,여의나루역 1번출구 앞,미성아파트 A동 앞,http://map.daum.net/?sName=여의나루역 1번출구 앞 대여소&eName=미성아파트 A동 앞 대여소&target=bicycle
215,220,65,165,5285,6023,-100,-738,2,0.434782609,여의도고교 앞,미성아파트 A동 앞,http://map.daum.net/?sName=여의도고교 앞 대여소&eName=미성아파트 A동 앞 대여소&target=bicycle
207,218,477,228,48130,45467,249,2663,4,0.353191489,여의나루역 1번출구 앞,증권거래소 앞,http://map.daum.net/?sName=여의나루역 1번출구 앞 대여소&eName=증권거래소 앞 대여소&target=bicycle
211,218,267,465,12700,11273,-198,1427,3,0.270491803,여의도역 4번출구 옆,증권거래소 앞,http://map.daum.net/?sName=여의도역 4번출구 옆 대여소&eName=증권거래소 앞 대여소&target=bicycle
207,2217,148,89,48130,45467,59,2663,1,0.248945148,여의나루역 1번출구 앞,아크로리버뷰 부지 앞,http://map.daum.net/?sName=여의나루역 1번출구 앞 대여소&eName=아크로리버뷰 부지 앞 대여소&target=bicycle
207,825,175,109,48130,45467,66,2663,1,0.232394366,여의나루역 1번출구 앞,서빙고동 주민센터 앞,http://map.daum.net/?sName=여의나루역 1번출구 앞 대여소&eName=서빙고동 주민센터 앞 대여소&target=bicycle
810,825,167,79,2877,2444,88,433,1,0.357723577,이태원지하보도,서빙고동 주민센터 앞,http://map.daum.net/?sName=이태원지하보도 대여소&eName=서빙고동 주민센터 앞 대여소&target=bicycle
2301,825,148,90,11870,12222,58,-352,1,0.243697479,현대고등학교 건너편,서빙고동 주민센터 앞,http://map.daum.net/?sName=현대고등학교 건너편 대여소&eName=서빙고동 주민센터 앞 대여소&target=bicycle
815,825,246,162,5823,5886,84,-63,1,0.205882353,LIG강촌아파트 103동앞,서빙고동 주민센터 앞,http://map.daum.net/?sName=LIG강촌아파트 103동앞 대여소&eName=서빙고동 주민센터 앞 대여소&target=bicycle
207,248,743,481,48130,45467,262,2663,5,0.214052288,여의나루역 1번출구 앞,초원아파트 앞,http://map.daum.net/?sName=여의나루역 1번출구 앞 대여소&eName=초원아파트 앞 대여소&target=bicycle
147,248,81,145,9441,11290,-64,-1849,1,0.283185841,마포역 4번출구 뒤,초원아파트 앞,http://map.daum.net/?sName=마포역 4번출구 뒤 대여소&eName=초원아파트 앞 대여소&target=bicycle
202,248,224,142,13050,14170,82,-1120,1,0.224043716,국민일보 앞,초원아파트 앞,http://map.daum.net/?sName=국민일보 앞 대여소&eName=초원아파트 앞 대여소&target=bicycle
210,248,363,238,20427,20741,125,-314,2,0.207986689,IFC몰,초원아파트 앞,http://map.daum.net/?sName=IFC몰 대여소&eName=초원아파트 앞 대여소&target=bicycle
2008,2065,172,47,2341,1823,125,518,2,0.570776256,노량진근린공원 대방공원,서울시여성가족재단,http://map.daum.net/?sName=노량진근린공원 대방공원 대여소&eName=서울시여성가족재단 대여소&target=bicycle
118,148,154,75,7742,7577,79,165,1,0.344978166,광흥창역 2번출구 앞,용강동 주민센터 앞,http://map.daum.net/?sName=광흥창역 2번출구 앞 대여소&eName=용강동 주민센터 앞 대여소&target=bicycle
145,148,145,91,6277,6626,54,-349,1,0.228813559,공덕역 5번출구,용강동 주민센터 앞,http://map.daum.net/?sName=공덕역 5번출구 대여소&eName=용강동 주민센터 앞 대여소&target=bicycle
2025,2040,71,257,11454,12542,-186,-1088,3,0.567073171,흑석역 1번출구,비계 버스정류소,http://map.daum.net/?sName=흑석역 1번출구 대여소&eName=비계 버스정류소 대여소&target=bicycle
2025,2064,60,209,11454,12542,-149,-1088,2,0.553903346,흑석역 1번출구,흑석한강푸르지오 106동앞,http://map.daum.net/?sName=흑석역 1번출구 대여소&eName=흑석한강푸르지오 106동앞 대여소&target=bicycle
2027,2064,71,169,3850,3914,-98,-64,1,0.408333333,중앙대학교 정문,흑석한강푸르지오 106동앞,http://map.daum.net/?sName=중앙대학교 정문 대여소&eName=흑석한강푸르지오 106동앞 대여소&target=bicycle
2025,2026,83,234,11454,12542,-151,-1088,3,0.476340694,흑석역 1번출구,흑석역 4번출구,http://map.daum.net/?sName=흑석역 1번출구 대여소&eName=흑석역 4번출구 대여소&target=bicycle
2025,2027,290,562,11454,12542,-272,-1088,5,0.319248826,흑석역 1번출구,중앙대학교 정문,http://map.daum.net/?sName=흑석역 1번출구 대여소&eName=중앙대학교 정문 대여소&target=bicycle
3509,563,214,60,12147,12530,154,-383,3,0.562043796,세종사이버대학교,성동세무서 건너편,http://map.daum.net/?sName=세종사이버대학교 대여소&eName=성동세무서 건너편 대여소&target=bicycle
508,563,764,242,4672,4093,522,579,10,0.51888668,성수아카데미타워 앞,성동세무서 건너편,http://map.daum.net/?sName=성수아카데미타워 앞 대여소&eName=성동세무서 건너편 대여소&target=bicycle
516,563,164,63,6092,5813,101,279,2,0.444933921,광진메디칼 앞,성동세무서 건너편,http://map.daum.net/?sName=광진메디칼 앞 대여소&eName=성동세무서 건너편 대여소&target=bicycle
500,563,375,194,13978,12760,181,1218,3,0.318101933,어린이대공원역 3번출구 앞,성동세무서 건너편,http://map.daum.net/?sName=어린이대공원역 3번출구 앞 대여소&eName=성동세무서 건너편 대여소&target=bicycle
509,563,314,192,11463,12376,122,-913,2,0.241106719,이마트 버스정류소 옆,성동세무서 건너편,http://map.daum.net/?sName=이마트 버스정류소 옆 대여소&eName=성동세무서 건너편 대여소&target=bicycle
3518,563,250,125,11134,11354,125,-220,2,0.333333333,군자역 7번출구뒤,성동세무서 건너편,http://map.daum.net/?sName=군자역 7번출구뒤 대여소&eName=성동세무서 건너편 대여소&target=bicycle
3509,574,166,290,12147,12530,-124,-383,2,0.271929825,세종사이버대학교,아차산역4번출구,http://map.daum.net/?sName=세종사이버대학교 대여소&eName=아차산역4번출구 대여소&target=bicycle
3500,574,153,242,5750,5761,-89,-11,1,0.225316456,군자역2번출구,아차산역4번출구,http://map.daum.net/?sName=군자역2번출구 대여소&eName=아차산역4번출구 대여소&target=bicycle
3518,574,269,407,11134,11354,-138,-220,2,0.204142012,군자역 7번출구뒤,아차산역4번출구,http://map.daum.net/?sName=군자역 7번출구뒤 대여소&eName=아차산역4번출구 대여소&target=bicycle
573,574,119,230,8532,8399,-111,133,2,0.318051576,구의문주차장 앞,아차산역4번출구,http://map.daum.net/?sName=구의문주차장 앞 대여소&eName=아차산역4번출구 대여소&target=bicycle
3520,574,80,131,7586,7409,-51,177,1,0.241706161,광진경찰서,아차산역4번출구,http://map.daum.net/?sName=광진경찰서 대여소&eName=아차산역4번출구 대여소&target=bicycle
3509,567,155,96,12147,12530,59,-383,1,0.235059761,세종사이버대학교,성수역 2번출구 앞,http://map.daum.net/?sName=세종사이버대학교 대여소&eName=성수역 2번출구 앞 대여소&target=bicycle
502,567,78,195,40455,46318,-117,-5863,2,0.428571429,뚝섬유원지역 1번출구 앞,성수역 2번출구 앞,http://map.daum.net/?sName=뚝섬유원지역 1번출구 앞 대여소&eName=성수역 2번출구 앞 대여소&target=bicycle
516,567,144,79,6092,5813,65,279,1,0.291479821,광진메디칼 앞,성수역 2번출구 앞,http://map.daum.net/?sName=광진메디칼 앞 대여소&eName=성수역 2번출구 앞 대여소&target=bicycle
511,567,84,202,11962,11731,-118,231,2,0.412587413,서울숲역 4번 출구 옆,성수역 2번출구 앞,http://map.daum.net/?sName=서울숲역 4번 출구 옆 대여소&eName=성수역 2번출구 앞 대여소&target=bicycle
509,567,143,232,11463,12376,-89,-913,1,0.237333333,이마트 버스정류소 옆,성수역 2번출구 앞,http://map.daum.net/?sName=이마트 버스정류소 옆 대여소&eName=성수역 2번출구 앞 대여소&target=bicycle
3509,500,232,349,12147,12530,-117,-383,2,0.201376936,세종사이버대학교,어린이대공원역 3번출구 앞,http://map.daum.net/?sName=세종사이버대학교 대여소&eName=어린이대공원역 3번출구 앞 대여소&target=bicycle
3518,500,307,485,11134,11354,-178,-220,3,0.224747475,군자역 7번출구뒤,어린이대공원역 3번출구 앞,http://map.daum.net/?sName=군자역 7번출구뒤 대여소&eName=어린이대공원역 3번출구 앞 대여소&target=bicycle
634,651,201,342,13423,14371,-141,-948,2,0.259668508,외국어대 정문 앞,우리은행청량리지점앞,http://map.daum.net/?sName=외국어대 정문 앞 대여소&eName=우리은행청량리지점앞 대여소&target=bicycle
623,651,287,173,10901,6644,114,4257,2,0.247826087,서울시립대 정문 앞,우리은행청량리지점앞,http://map.daum.net/?sName=서울시립대 정문 앞 대여소&eName=우리은행청량리지점앞 대여소&target=bicycle
911,917,96,334,5465,5400,-238,65,4,0.553488372,은평평화공원(역촌역4번출구),녹번역 4번출구,http://map.daum.net/?sName=은평평화공원(역촌역4번출구) 대여소&eName=녹번역 4번출구 대여소&target=bicycle
913,917,134,404,10860,11389,-270,-529,5,0.501858736,이마트 은평점,녹번역 4번출구,http://map.daum.net/?sName=이마트 은평점 대여소&eName=녹번역 4번출구 대여소&target=bicycle
907,917,148,278,17334,21700,-130,-4366,2,0.305164319,CJ 드림시티,녹번역 4번출구,http://map.daum.net/?sName=CJ 드림시티 대여소&eName=녹번역 4번출구 대여소&target=bicycle
911,943,531,246,5465,5400,285,65,5,0.366795367,은평평화공원(역촌역4번출구),은평구청 보건소,http://map.daum.net/?sName=은평평화공원(역촌역4번출구) 대여소&eName=은평구청 보건소 대여소&target=bicycle
907,943,196,295,17334,21700,-99,-4366,1,0.201629328,CJ 드림시티,은평구청 보건소,http://map.daum.net/?sName=CJ 드림시티 대여소&eName=은평구청 보건소 대여소&target=bicycle
901,943,69,154,4032,4189,-85,-157,1,0.381165919,응암1동사무소,은평구청 보건소,http://map.daum.net/?sName=응암1동사무소 대여소&eName=은평구청 보건소 대여소&target=bicycle
911,939,152,81,5465,5400,71,65,1,0.30472103,은평평화공원(역촌역4번출구),은평구청 교차로,http://map.daum.net/?sName=은평평화공원(역촌역4번출구) 대여소&eName=은평구청 교차로 대여소&target=bicycle
913,939,135,204,10860,11389,-69,-529,1,0.203539823,이마트 은평점,은평구청 교차로,http://map.daum.net/?sName=이마트 은평점 대여소&eName=은평구청 교차로 대여소&target=bicycle
907,939,130,369,17334,21700,-239,-4366,4,0.478957916,CJ 드림시티,은평구청 교차로,http://map.daum.net/?sName=CJ 드림시티 대여소&eName=은평구청 교차로 대여소&target=bicycle
917,939,228,142,4414,3627,86,787,1,0.232432432,녹번역 4번출구,은평구청 교차로,http://map.daum.net/?sName=녹번역 4번출구 대여소&eName=은평구청 교차로 대여소&target=bicycle
2103,2145,177,51,5231,5558,126,-327,2,0.552631579,신림동 우방아파트,은천초등학교 육교,http://map.daum.net/?sName=신림동 우방아파트 대여소&eName=은천초등학교 육교 대여소&target=bicycle
2109,2145,110,189,6258,7811,-79,-1553,1,0.264214047,은천로입구 가로공원,은천초등학교 육교,http://map.daum.net/?sName=은천로입구 가로공원 대여소&eName=은천초등학교 육교 대여소&target=bicycle
2059,2145,100,194,5522,5993,-94,-471,1,0.319727891,보라매공원 정문,은천초등학교 육교,http://map.daum.net/?sName=보라매공원 정문 대여소&eName=은천초등학교 육교 대여소&target=bicycle
2103,2113,94,145,5231,5558,-51,-327,1,0.213389121,신림동 우방아파트,관악동작견인차량보관소,http://map.daum.net/?sName=신림동 우방아파트 대여소&eName=관악동작견인차량보관소 대여소&target=bicycle
2012,2113,200,118,5149,5461,82,-312,1,0.257861635,녹십초요양병원앞,관악동작견인차량보관소,http://map.daum.net/?sName=녹십초요양병원앞 대여소&eName=관악동작견인차량보관소 대여소&target=bicycle
2103,2173,127,192,5231,5558,-65,-327,1,0.203761755,신림동 우방아파트,당곡사거리,http://map.daum.net/?sName=신림동 우방아파트 대여소&eName=당곡사거리 대여소&target=bicycle
2153,2173,138,208,2426,2856,-70,-430,1,0.202312139,서울남부초등학교 옆,당곡사거리,http://map.daum.net/?sName=서울남부초등학교 옆 대여소&eName=당곡사거리 대여소&target=bicycle
507,508,49,170,4250,4538,-121,-288,2,0.552511416,성수아이에스비즈타워 앞,성수아카데미타워 앞,http://map.daum.net/?sName=성수아이에스비즈타워 앞 대여소&eName=성수아카데미타워 앞 대여소&target=bicycle
588,593,226,66,7387,6883,160,504,3,0.547945205,뚝섬 유원지역,자양중앙나들목,http://map.daum.net/?sName=뚝섬 유원지역 대여소&eName=자양중앙나들목 대여소&target=bicycle
546,593,172,67,6752,7127,105,-375,2,0.439330544,잠실대교북단 교차로,자양중앙나들목,http://map.daum.net/?sName=잠실대교북단 교차로 대여소&eName=자양중앙나들목 대여소&target=bicycle
503,593,356,181,8329,7098,175,1231,3,0.325884544,더샵스타시티 C동 앞,자양중앙나들목,http://map.daum.net/?sName=더샵스타시티 C동 앞 대여소&eName=자양중앙나들목 대여소&target=bicycle
2111,2130,67,228,4549,4296,-161,253,3,0.545762712,서울대입구역 1번출구,영어마을 관악캠프,http://map.daum.net/?sName=서울대입구역 1번출구 대여소&eName=영어마을 관악캠프 대여소&target=bicycle
2122,2130,95,260,5117,4815,-165,302,3,0.464788732,낙성대로 입구,영어마을 관악캠프,http://map.daum.net/?sName=낙성대로 입구 대여소&eName=영어마을 관악캠프 대여소&target=bicycle
2129,2130,73,132,3395,2239,-59,1156,1,0.287804878,낙성대 과학전시관,영어마을 관악캠프,http://map.daum.net/?sName=낙성대 과학전시관 대여소&eName=영어마을 관악캠프 대여소&target=bicycle
2111,2165,85,167,4549,4296,-82,253,1,0.325396825,서울대입구역 1번출구,JK장평타워,http://map.daum.net/?sName=서울대입구역 1번출구 대여소&eName=JK장평타워 대여소&target=bicycle
2111,2129,194,304,4549,4296,-110,253,2,0.220883534,서울대입구역 1번출구,낙성대 과학전시관,http://map.daum.net/?sName=서울대입구역 1번출구 대여소&eName=낙성대 과학전시관 대여소&target=bicycle
2122,2129,275,463,5117,4815,-188,302,3,0.254742547,낙성대로 입구,낙성대 과학전시관,http://map.daum.net/?sName=낙성대로 입구 대여소&eName=낙성대 과학전시관 대여소&target=bicycle
2128,2129,62,148,2415,2082,-86,333,1,0.40952381,관악구청교차로,낙성대 과학전시관,http://map.daum.net/?sName=관악구청교차로 대여소&eName=낙성대 과학전시관 대여소&target=bicycle
1430,1433,359,108,4837,3205,251,1632,5,0.537473233,중랑구청,중화역 2번출구,http://map.daum.net/?sName=중랑구청 대여소&eName=중화역 2번출구 대여소&target=bicycle
1430,1449,250,114,4837,3205,136,1632,2,0.373626374,중랑구청,상봉역 1번출구,http://map.daum.net/?sName=중랑구청 대여소&eName=상봉역 1번출구 대여소&target=bicycle
1446,1449,69,131,4425,5090,-62,-665,1,0.31,중랑전화국 교차로,상봉역 1번출구,http://map.daum.net/?sName=중랑전화국 교차로 대여소&eName=상봉역 1번출구 대여소&target=bicycle
1448,1449,190,366,7251,7472,-176,-221,3,0.316546763,코스트코 상봉점,상봉역 1번출구,http://map.daum.net/?sName=코스트코 상봉점 대여소&eName=상봉역 1번출구 대여소&target=bicycle
1430,1448,142,72,4837,3205,70,1632,1,0.327102804,중랑구청,코스트코 상봉점,http://map.daum.net/?sName=중랑구청 대여소&eName=코스트코 상봉점 대여소&target=bicycle
1404,1448,358,192,4224,4019,166,205,3,0.301818182,동일로 지하차도,코스트코 상봉점,http://map.daum.net/?sName=동일로 지하차도 대여소&eName=코스트코 상봉점 대여소&target=bicycle
1416,1448,333,215,2935,2539,118,396,2,0.215328467,상봉역 3번출구,코스트코 상봉점,http://map.daum.net/?sName=상봉역 3번출구 대여소&eName=코스트코 상봉점 대여소&target=bicycle
553,578,280,145,4341,4839,135,-498,2,0.317647059,중곡 성원APT 앞,성동세무서 부근,http://map.daum.net/?sName=중곡 성원APT 앞 대여소&eName=성동세무서 부근 대여소&target=bicycle
516,578,138,77,6092,5813,61,279,1,0.28372093,광진메디칼 앞,성동세무서 부근,http://map.daum.net/?sName=광진메디칼 앞 대여소&eName=성동세무서 부근 대여소&target=bicycle
560,578,218,100,5244,5482,118,-238,2,0.371069182,비전교회 앞,성동세무서 부근,http://map.daum.net/?sName=비전교회 앞 대여소&eName=성동세무서 부근 대여소&target=bicycle
512,578,102,214,11719,11213,-112,506,2,0.35443038,뚝섬역 1번 출구 옆,성동세무서 부근,http://map.daum.net/?sName=뚝섬역 1번 출구 옆 대여소&eName=성동세무서 부근 대여소&target=bicycle
2109,2164,53,175,6258,7811,-122,-1553,2,0.535087719,은천로입구 가로공원,관악우체국,http://map.daum.net/?sName=은천로입구 가로공원 대여소&eName=관악우체국 대여소&target=bicycle
2145,2164,194,82,3322,3273,112,49,2,0.405797101,은천초등학교 육교,관악우체국,http://map.daum.net/?sName=은천초등학교 육교 대여소&eName=관악우체국 대여소&target=bicycle
2108,2164,82,186,5185,5464,-104,-279,2,0.388059701,은천치안센터,관악우체국,http://map.daum.net/?sName=은천치안센터 대여소&eName=관악우체국 대여소&target=bicycle
2136,2164,170,79,7092,7283,91,-191,1,0.365461847,신림역 8번출구,관악우체국,http://map.daum.net/?sName=신림역 8번출구 대여소&eName=관악우체국 대여소&target=bicycle
2139,2164,69,138,12535,13756,-69,-1221,1,0.333333333,서울신성초등학교,관악우체국,http://map.daum.net/?sName=서울신성초등학교 대여소&eName=관악우체국 대여소&target=bicycle
2109,2122,86,176,6258,7811,-90,-1553,1,0.34351145,은천로입구 가로공원,낙성대로 입구,http://map.daum.net/?sName=은천로입구 가로공원 대여소&eName=낙성대로 입구 대여소&target=bicycle
2108,2122,110,192,5185,5464,-82,-279,1,0.271523179,은천치안센터,낙성대로 입구,http://map.daum.net/?sName=은천치안센터 대여소&eName=낙성대로 입구 대여소&target=bicycle
2109,2176,75,147,6258,7811,-72,-1553,1,0.324324324,은천로입구 가로공원,보라매공원 보도육교,http://map.daum.net/?sName=은천로입구 가로공원 대여소&eName=보라매공원 보도육교 대여소&target=bicycle
2106,2176,99,177,4513,6078,-78,-1565,1,0.282608696,난곡 새마을금고,보라매공원 보도육교,http://map.daum.net/?sName=난곡 새마을금고 대여소&eName=보라매공원 보도육교 대여소&target=bicycle
2109,2116,96,177,6258,7811,-81,-1553,1,0.296703297,은천로입구 가로공원,에이스에이존빌딩,http://map.daum.net/?sName=은천로입구 가로공원 대여소&eName=에이스에이존빌딩 대여소&target=bicycle
2230,2283,79,260,8018,8436,-181,-418,3,0.533923304,이수역 4번 출구,그룹한빌딩옆,http://map.daum.net/?sName=이수역 4번 출구 대여소&eName=그룹한빌딩옆 대여소&target=bicycle
912,934,51,167,7131,9170,-116,-2039,2,0.532110092,응암오거리,신사동 성당,http://map.daum.net/?sName=응암오거리 대여소&eName=신사동 성당 대여소&target=bicycle
907,934,94,178,17334,21700,-84,-4366,1,0.308823529,CJ 드림시티,신사동 성당,http://map.daum.net/?sName=CJ 드림시티 대여소&eName=신사동 성당 대여소&target=bicycle
914,934,111,254,11332,13642,-143,-2310,2,0.391780822,새절역 2번출구,신사동 성당,http://map.daum.net/?sName=새절역 2번출구 대여소&eName=신사동 성당 대여소&target=bicycle
912,926,90,190,7131,9170,-100,-2039,2,0.357142857,응암오거리,불광역 8번출구,http://map.daum.net/?sName=응암오거리 대여소&eName=불광역 8번출구 대여소&target=bicycle
922,926,225,123,2316,2060,102,256,2,0.293103448,연신내역 4번출구,불광역 8번출구,http://map.daum.net/?sName=연신내역 4번출구 대여소&eName=불광역 8번출구 대여소&target=bicycle
535,536,252,77,3792,2126,175,1666,3,0.531914894,응봉삼거리,행당역 2번출구 앞,http://map.daum.net/?sName=응봉삼거리 대여소&eName=행당역 2번출구 앞 대여소&target=bicycle
535,569,210,135,3792,2126,75,1666,1,0.217391304,응봉삼거리,응봉현대아파트 정류소,http://map.daum.net/?sName=응봉삼거리 대여소&eName=응봉현대아파트 정류소 대여소&target=bicycle
559,569,143,89,9438,9087,54,351,1,0.232758621,왕십리역 4번 출구 건너편,응봉현대아파트 정류소,http://map.daum.net/?sName=왕십리역 4번 출구 건너편 대여소&eName=응봉현대아파트 정류소 대여소&target=bicycle
1316,1318,161,72,2445,1306,89,1139,1,0.381974249,고려사대부속중고 건너편,길음역 3번출구 뒤,http://map.daum.net/?sName=고려사대부속중고 건너편 대여소&eName=길음역 3번출구 뒤 대여소&target=bicycle
326,331,263,81,6346,5294,182,1052,3,0.529069767,안국역 5번출구 앞,을지로2가 사거리 북측,http://map.daum.net/?sName=안국역 5번출구 앞 대여소&eName=을지로2가 사거리 북측 대여소&target=bicycle
327,331,236,104,7393,6943,132,450,2,0.388235294,낙원상가 옆,을지로2가 사거리 북측,http://map.daum.net/?sName=낙원상가 옆 대여소&eName=을지로2가 사거리 북측 대여소&target=bicycle
311,331,325,196,12978,9711,129,3267,2,0.247600768,서울광장 옆,을지로2가 사거리 북측,http://map.daum.net/?sName=서울광장 옆 대여소&eName=을지로2가 사거리 북측 대여소&target=bicycle
326,352,62,178,6346,5294,-116,1052,2,0.483333333,안국역 5번출구 앞,중앙고입구 삼거리,http://map.daum.net/?sName=안국역 5번출구 앞 대여소&eName=중앙고입구 삼거리 대여소&target=bicycle
328,352,58,185,8402,7665,-127,737,2,0.522633745,탑골공원 앞,중앙고입구 삼거리,http://map.daum.net/?sName=탑골공원 앞 대여소&eName=중앙고입구 삼거리 대여소&target=bicycle
327,352,92,145,7393,6943,-53,450,1,0.223628692,낙원상가 옆,중앙고입구 삼거리,http://map.daum.net/?sName=낙원상가 옆 대여소&eName=중앙고입구 삼거리 대여소&target=bicycle
326,385,158,67,6346,5294,91,1052,1,0.404444444,안국역 5번출구 앞,종각역 5번출구,http://map.daum.net/?sName=안국역 5번출구 앞 대여소&eName=종각역 5번출구 대여소&target=bicycle
370,385,142,65,4900,4438,77,462,1,0.371980676,시청역(2호선) 9번출구 뒤,종각역 5번출구,http://map.daum.net/?sName=시청역(2호선) 9번출구 뒤 대여소&eName=종각역 5번출구 대여소&target=bicycle
303,385,578,280,8375,7554,298,821,5,0.347319347,광화문역 1번출구 앞,종각역 5번출구,http://map.daum.net/?sName=광화문역 1번출구 앞 대여소&eName=종각역 5번출구 대여소&target=bicycle
335,385,69,136,5627,5532,-67,95,1,0.326829268,종로3가역 15번출구 앞,종각역 5번출구,http://map.daum.net/?sName=종로3가역 15번출구 앞 대여소&eName=종각역 5번출구 대여소&target=bicycle
306,385,149,86,6507,5357,63,1150,1,0.268085106,광화문역 7번출구 앞,종각역 5번출구,http://map.daum.net/?sName=광화문역 7번출구 앞 대여소&eName=종각역 5번출구 대여소&target=bicycle
308,385,218,144,4460,4300,74,160,1,0.20441989,광화문 S타워 앞,종각역 5번출구,http://map.daum.net/?sName=광화문 S타워 앞 대여소&eName=종각역 5번출구 대여소&target=bicycle
326,359,191,81,6346,5294,110,1052,2,0.404411765,안국역 5번출구 앞,원남동사거리,http://map.daum.net/?sName=안국역 5번출구 앞 대여소&eName=원남동사거리 대여소&target=bicycle
339,359,438,249,7812,7486,189,326,3,0.27510917,종로4가 사거리,원남동사거리,http://map.daum.net/?sName=종로4가 사거리 대여소&eName=원남동사거리 대여소&target=bicycle
563,571,164,532,7356,8744,-368,-1388,7,0.528735632,성동세무서 건너편,어린이대공원역6번출구,http://map.daum.net/?sName=성동세무서 건너편 대여소&eName=어린이대공원역6번출구 대여소&target=bicycle
501,571,94,292,17654,17669,-198,-15,3,0.512953368,광진구의회 앞,어린이대공원역6번출구,http://map.daum.net/?sName=광진구의회 앞 대여소&eName=어린이대공원역6번출구 대여소&target=bicycle
502,571,137,330,40455,46318,-193,-5863,3,0.413276231,뚝섬유원지역 1번출구 앞,어린이대공원역6번출구,http://map.daum.net/?sName=뚝섬유원지역 1번출구 앞 대여소&eName=어린이대공원역6번출구 대여소&target=bicycle
3508,571,151,378,10672,10429,-227,243,4,0.429111531,화양사거리,어린이대공원역6번출구,http://map.daum.net/?sName=화양사거리 대여소&eName=어린이대공원역6번출구 대여소&target=bicycle
563,573,66,164,7356,8744,-98,-1388,1,0.426086957,성동세무서 건너편,구의문주차장 앞,http://map.daum.net/?sName=성동세무서 건너편 대여소&eName=구의문주차장 앞 대여소&target=bicycle
516,573,105,277,6092,5813,-172,279,3,0.45026178,광진메디칼 앞,구의문주차장 앞,http://map.daum.net/?sName=광진메디칼 앞 대여소&eName=구의문주차장 앞 대여소&target=bicycle
3508,573,128,198,10672,10429,-70,243,1,0.214723926,화양사거리,구의문주차장 앞,http://map.daum.net/?sName=화양사거리 대여소&eName=구의문주차장 앞 대여소&target=bicycle
514,573,75,156,11672,12181,-81,-509,1,0.350649351,성수사거리 버스정류장 앞,구의문주차장 앞,http://map.daum.net/?sName=성수사거리 버스정류장 앞 대여소&eName=구의문주차장 앞 대여소&target=bicycle
3516,573,280,181,3353,3238,99,115,1,0.214750542,구의아리수정수센터앞,구의문주차장 앞,http://map.daum.net/?sName=구의아리수정수센터앞 대여소&eName=구의문주차장 앞 대여소&target=bicycle
549,573,593,386,9036,9338,207,-302,4,0.211440245,아차산역 3번출구,구의문주차장 앞,http://map.daum.net/?sName=아차산역 3번출구 대여소&eName=구의문주차장 앞 대여소&target=bicycle
213,217,208,106,8227,6685,102,1542,2,0.324840764,KT앞,NH농협은행 앞,http://map.daum.net/?sName=KT앞 대여소&eName=NH농협은행 앞 대여소&target=bicycle
216,217,68,163,6399,6478,-95,-79,1,0.411255411,삼부아파트1동 앞,NH농협은행 앞,http://map.daum.net/?sName=삼부아파트1동 앞 대여소&eName=NH농협은행 앞 대여소&target=bicycle
372,565,155,48,3521,3333,107,188,2,0.527093596,약수역 3번출구 뒤,옥수역 3번출구,http://map.daum.net/?sName=약수역 3번출구 뒤 대여소&eName=옥수역 3번출구 대여소&target=bicycle
534,565,221,112,2598,2481,109,117,2,0.327327327,금호사거리,옥수역 3번출구,http://map.daum.net/?sName=금호사거리 대여소&eName=옥수역 3번출구 대여소&target=bicycle
2309,2348,233,73,3079,1833,160,1246,3,0.522875817,청담역(우리들병원 앞),포스코사거리(기업은행),http://map.daum.net/?sName=청담역(우리들병원 앞) 대여소&eName=포스코사거리(기업은행) 대여소&target=bicycle
2318,2348,198,92,3440,2514,106,926,2,0.365517241,삼성중앙역4번출구(문화센터더 리빌),포스코사거리(기업은행),http://map.daum.net/?sName=삼성중앙역4번출구(문화센터더 리빌) 대여소&eName=포스코사거리(기업은행) 대여소&target=bicycle
1224,2348,140,83,7704,7777,57,-73,1,0.255605381,아시아지하보도 2번 출구,포스코사거리(기업은행),http://map.daum.net/?sName=아시아지하보도 2번 출구 대여소&eName=포스코사거리(기업은행) 대여소&target=bicycle
2309,2312,186,70,3079,1833,116,1246,2,0.453125,청담역(우리들병원 앞),청담역 13번 출구 앞,http://map.daum.net/?sName=청담역(우리들병원 앞) 대여소&eName=청담역 13번 출구 앞 대여소&target=bicycle
2309,2318,162,86,3079,1833,76,1246,1,0.306451613,청담역(우리들병원 앞),삼성중앙역4번출구(문화센터더 리빌),http://map.daum.net/?sName=청담역(우리들병원 앞) 대여소&eName=삼성중앙역4번출구(문화센터더 리빌) 대여소&target=bicycle
2315,2318,77,150,5723,5593,-73,130,1,0.321585903,봉은사역 5번출구 옆,삼성중앙역4번출구(문화센터더 리빌),http://map.daum.net/?sName=봉은사역 5번출구 옆 대여소&eName=삼성중앙역4번출구(문화센터더 리빌) 대여소&target=bicycle
328,355,83,141,8402,7665,-58,737,1,0.258928571,탑골공원 앞,서울사대부속초교 앞,http://map.daum.net/?sName=탑골공원 앞 대여소&eName=서울사대부속초교 앞 대여소&target=bicycle
345,355,140,245,5640,5863,-105,-223,2,0.272727273,서울보증보험본사 앞,서울사대부속초교 앞,http://map.daum.net/?sName=서울보증보험본사 앞 대여소&eName=서울사대부속초교 앞 대여소&target=bicycle
1306,355,170,90,7479,7356,80,123,1,0.307692308,한성대입구역2번출구,서울사대부속초교 앞,http://map.daum.net/?sName=한성대입구역2번출구 대여소&eName=서울사대부속초교 앞 대여소&target=bicycle
338,355,117,186,7569,6962,-69,607,1,0.227722772,세운스퀘어 앞,서울사대부속초교 앞,http://map.daum.net/?sName=세운스퀘어 앞 대여소&eName=서울사대부속초교 앞 대여소&target=bicycle
334,355,77,150,10121,9952,-73,169,1,0.321585903,종로3가역 2번출구 뒤,서울사대부속초교 앞,http://map.daum.net/?sName=종로3가역 2번출구 뒤 대여소&eName=서울사대부속초교 앞 대여소&target=bicycle
340,355,254,132,7930,7676,122,254,2,0.316062176,혜화동 로터리,서울사대부속초교 앞,http://map.daum.net/?sName=혜화동 로터리 대여소&eName=서울사대부속초교 앞 대여소&target=bicycle
339,355,140,220,7812,7486,-80,326,1,0.222222222,종로4가 사거리,서울사대부속초교 앞,http://map.daum.net/?sName=종로4가 사거리 대여소&eName=서울사대부속초교 앞 대여소&target=bicycle
328,339,147,230,8402,7665,-83,737,1,0.220159151,탑골공원 앞,종로4가 사거리,http://map.daum.net/?sName=탑골공원 앞 대여소&eName=종로4가 사거리 대여소&target=bicycle
328,358,273,181,8402,7665,92,737,1,0.202643172,탑골공원 앞,성대입구 사거리,http://map.daum.net/?sName=탑골공원 앞 대여소&eName=성대입구 사거리 대여소&target=bicycle
343,358,280,110,3457,3068,170,389,3,0.435897436,예일빌딩(율곡로) 앞,성대입구 사거리,http://map.daum.net/?sName=예일빌딩(율곡로) 앞 대여소&eName=성대입구 사거리 대여소&target=bicycle
1343,358,217,99,3030,2216,118,814,2,0.373417722,한성대7번출구 앞,성대입구 사거리,http://map.daum.net/?sName=한성대7번출구 앞 대여소&eName=성대입구 사거리 대여소&target=bicycle
346,358,98,220,8796,9250,-122,-454,2,0.383647799,맥스타일 앞,성대입구 사거리,http://map.daum.net/?sName=맥스타일 앞 대여소&eName=성대입구 사거리 대여소&target=bicycle
2243,2273,287,90,4367,2763,197,1604,3,0.522546419,서울가정법원,일동제약 사거리,http://map.daum.net/?sName=서울가정법원 대여소&eName=일동제약 사거리 대여소&target=bicycle
2242,2273,423,270,6053,4265,153,1788,3,0.220779221,양재역 11번 출구 앞,일동제약 사거리,http://map.daum.net/?sName=양재역 11번 출구 앞 대여소&eName=일동제약 사거리 대여소&target=bicycle
2250,2273,148,97,2373,2230,51,143,1,0.208163265,서초유치원 맞은편,일동제약 사거리,http://map.daum.net/?sName=서초유치원 맞은편 대여소&eName=일동제약 사거리 대여소&target=bicycle
2243,2247,193,79,4367,2763,114,1604,2,0.419117647,서울가정법원,섬들근린공원,http://map.daum.net/?sName=서울가정법원 대여소&eName=섬들근린공원 대여소&target=bicycle
2242,2247,261,94,6053,4265,167,1788,3,0.470422535,양재역 11번 출구 앞,섬들근린공원,http://map.daum.net/?sName=양재역 11번 출구 앞 대여소&eName=섬들근린공원 대여소&target=bicycle
2244,2247,177,95,5404,4975,82,429,1,0.301470588,교육개발원입구 교차로,섬들근린공원,http://map.daum.net/?sName=교육개발원입구 교차로 대여소&eName=섬들근린공원 대여소&target=bicycle
2243,2244,141,68,4367,2763,73,1604,1,0.349282297,서울가정법원,교육개발원입구 교차로,http://map.daum.net/?sName=서울가정법원 대여소&eName=교육개발원입구 교차로 대여소&target=bicycle
2243,2274,236,121,4367,2763,115,1604,2,0.322128852,서울가정법원,양재시민의숲역 3번출구,http://map.daum.net/?sName=서울가정법원 대여소&eName=양재시민의숲역 3번출구 대여소&target=bicycle
2242,2274,236,128,6053,4265,108,1788,2,0.296703297,양재역 11번 출구 앞,양재시민의숲역 3번출구,http://map.daum.net/?sName=양재역 11번 출구 앞 대여소&eName=양재시민의숲역 3번출구 대여소&target=bicycle
2251,2274,213,109,2827,2866,104,-39,2,0.322981366,더케이호텔 입구(양재2),양재시민의숲역 3번출구,http://map.daum.net/?sName=더케이호텔 입구(양재2) 대여소&eName=양재시민의숲역 3번출구 대여소&target=bicycle
2246,2274,118,186,2578,2772,-68,-194,1,0.223684211,서울시 품질시험소 앞,양재시민의숲역 3번출구,http://map.daum.net/?sName=서울시 품질시험소 앞 대여소&eName=양재시민의숲역 3번출구 대여소&target=bicycle
2243,2251,255,136,4367,2763,119,1604,2,0.304347826,서울가정법원,더케이호텔 입구(양재2),http://map.daum.net/?sName=서울가정법원 대여소&eName=더케이호텔 입구(양재2) 대여소&target=bicycle
2242,2251,283,175,6053,4265,108,1788,2,0.23580786,양재역 11번 출구 앞,더케이호텔 입구(양재2),http://map.daum.net/?sName=양재역 11번 출구 앞 대여소&eName=더케이호텔 입구(양재2) 대여소&target=bicycle
400,403,75,239,4593,5026,-164,-433,3,0.522292994,상암한화오벨리스크 1차 앞,부엉이공원 앞,http://map.daum.net/?sName=상암한화오벨리스크 1차 앞 대여소&eName=부엉이공원 앞 대여소&target=bicycle
400,402,83,169,4593,5026,-86,-433,1,0.341269841,상암한화오벨리스크 1차 앞,상암월드컵파크 9단지 앞,http://map.daum.net/?sName=상암한화오벨리스크 1차 앞 대여소&eName=상암월드컵파크 9단지 앞 대여소&target=bicycle
401,402,140,85,3713,4118,55,-405,1,0.244444444,상암월드컵파크 10단지 앞,상암월드컵파크 9단지 앞,http://map.daum.net/?sName=상암월드컵파크 10단지 앞 대여소&eName=상암월드컵파크 9단지 앞 대여소&target=bicycle
400,412,304,177,4593,5026,127,-433,2,0.264033264,상암한화오벨리스크 1차 앞,DMC산학협력연구센터 앞,http://map.daum.net/?sName=상암한화오벨리스크 1차 앞 대여소&eName=DMC산학협력연구센터 앞 대여소&target=bicycle
408,412,209,319,5319,5664,-110,-345,2,0.208333333,LG CNS앞,DMC산학협력연구센터 앞,http://map.daum.net/?sName=LG CNS앞 대여소&eName=DMC산학협력연구센터 앞 대여소&target=bicycle
508,513,167,77,4672,4093,90,579,1,0.368852459,성수아카데미타워 앞,뚝섬역 5번 출구 정류소 옆,http://map.daum.net/?sName=성수아카데미타워 앞 대여소&eName=뚝섬역 5번 출구 정류소 옆 대여소&target=bicycle
1132,1136,95,299,4285,4667,-204,-382,4,0.517766497,등촌역 7번출구,등촌2파출소,http://map.daum.net/?sName=등촌역 7번출구 대여소&eName=등촌2파출소 대여소&target=bicycle
1132,1135,360,622,4285,4667,-262,-382,5,0.266802444,등촌역 7번출구,강서구의회,http://map.daum.net/?sName=등촌역 7번출구 대여소&eName=강서구의회 대여소&target=bicycle
1118,1135,155,245,8828,10711,-90,-1883,1,0.225,증미역 3번출구뒤(등촌두산위브센티움오피스텔),강서구의회,http://map.daum.net/?sName=증미역 3번출구뒤(등촌두산위브센티움오피스텔) 대여소&eName=강서구의회 대여소&target=bicycle
1122,1135,69,143,8709,9721,-74,-1012,1,0.349056604,황금내근린공원,강서구의회,http://map.daum.net/?sName=황금내근린공원 대여소&eName=강서구의회 대여소&target=bicycle
931,932,248,422,8421,10731,-174,-2310,3,0.259701493,역촌파출소,예일여중,http://map.daum.net/?sName=역촌파출소 대여소&eName=예일여중 대여소&target=bicycle
926,932,95,177,6546,6833,-82,-287,1,0.301470588,불광역 8번출구,예일여중,http://map.daum.net/?sName=불광역 8번출구 대여소&eName=예일여중 대여소&target=bicycle
1203,1258,63,196,7538,7877,-133,-339,2,0.513513514,밀리아나2빌딩 앞,가락미륭아파트 앞,http://map.daum.net/?sName=밀리아나2빌딩 앞 대여소&eName=가락미륭아파트 앞 대여소&target=bicycle
1257,1258,78,157,5360,5408,-79,-48,1,0.336170213,가락시장역 롯데마트앞,가락미륭아파트 앞,http://map.daum.net/?sName=가락시장역 롯데마트앞 대여소&eName=가락미륭아파트 앞 대여소&target=bicycle
1203,1230,140,298,7538,7877,-158,-339,3,0.360730594,밀리아나2빌딩 앞,송파중학교 정문,http://map.daum.net/?sName=밀리아나2빌딩 앞 대여소&eName=송파중학교 정문 대여소&target=bicycle
1201,1230,81,170,6406,7066,-89,-660,1,0.354581673,가락시장역 3번 출구,송파중학교 정문,http://map.daum.net/?sName=가락시장역 3번 출구 대여소&eName=송파중학교 정문 대여소&target=bicycle
501,584,108,264,17654,17669,-156,-15,3,0.419354839,광진구의회 앞,광진광장 교통섬,http://map.daum.net/?sName=광진구의회 앞 대여소&eName=광진광장 교통섬 대여소&target=bicycle
502,584,183,452,40455,46318,-269,-5863,5,0.423622047,뚝섬유원지역 1번출구 앞,광진광장 교통섬,http://map.daum.net/?sName=뚝섬유원지역 1번출구 앞 대여소&eName=광진광장 교통섬 대여소&target=bicycle
500,584,122,231,13978,12760,-109,1218,2,0.30878187,어린이대공원역 3번출구 앞,광진광장 교통섬,http://map.daum.net/?sName=어린이대공원역 3번출구 앞 대여소&eName=광진광장 교통섬 대여소&target=bicycle
501,549,166,96,17654,17669,70,-15,1,0.267175573,광진구의회 앞,아차산역 3번출구,http://map.daum.net/?sName=광진구의회 앞 대여소&eName=아차산역 3번출구 대여소&target=bicycle
3507,549,316,122,4854,3027,194,1827,3,0.442922374,어린이회관,아차산역 3번출구,http://map.daum.net/?sName=어린이회관 대여소&eName=아차산역 3번출구 대여소&target=bicycle
3508,549,196,86,10672,10429,110,243,2,0.390070922,화양사거리,아차산역 3번출구,http://map.daum.net/?sName=화양사거리 대여소&eName=아차산역 3번출구 대여소&target=bicycle
3500,549,71,148,5750,5761,-77,-11,1,0.351598174,군자역2번출구,아차산역 3번출구,http://map.daum.net/?sName=군자역2번출구 대여소&eName=아차산역 3번출구 대여소&target=bicycle
3518,549,204,339,11134,11354,-135,-220,2,0.248618785,군자역 7번출구뒤,아차산역 3번출구,http://map.daum.net/?sName=군자역 7번출구뒤 대여소&eName=아차산역 3번출구 대여소&target=bicycle
3517,549,80,136,4095,5208,-56,-1113,1,0.259259259,용마사거리,아차산역 3번출구,http://map.daum.net/?sName=용마사거리 대여소&eName=아차산역 3번출구 대여소&target=bicycle
540,549,154,258,11140,11235,-104,-95,2,0.252427184,군자역 7번출구 베스트샵 앞,아차산역 3번출구,http://map.daum.net/?sName=군자역 7번출구 베스트샵 앞 대여소&eName=아차산역 3번출구 대여소&target=bicycle
501,555,133,80,17654,17669,53,-15,1,0.248826291,광진구의회 앞,구의3동주민센터,http://map.daum.net/?sName=광진구의회 앞 대여소&eName=구의3동주민센터 대여소&target=bicycle
3504,555,150,99,6893,6202,51,691,1,0.204819277,원일교회,구의3동주민센터,http://map.daum.net/?sName=원일교회 대여소&eName=구의3동주민센터 대여소&target=bicycle
704,711,59,183,9201,9423,-124,-222,2,0.512396694,남부법원검찰청 교차로,신일해피트리아파트 앞,http://map.daum.net/?sName=남부법원검찰청 교차로 대여소&eName=신일해피트리아파트 앞 대여소&target=bicycle
704,729,430,208,9201,9423,222,-222,4,0.347962382,남부법원검찰청 교차로,서부식자재마트 건너편,http://map.daum.net/?sName=남부법원검찰청 교차로 대여소&eName=서부식자재마트 건너편 대여소&target=bicycle
703,729,533,327,16446,17411,206,-965,4,0.239534884,오목교역 7번출구 앞,서부식자재마트 건너편,http://map.daum.net/?sName=오목교역 7번출구 앞 대여소&eName=서부식자재마트 건너편 대여소&target=bicycle
704,712,202,106,9201,9423,96,-222,1,0.311688312,남부법원검찰청 교차로,강월초교입구 사거리,http://map.daum.net/?sName=남부법원검찰청 교차로 대여소&eName=강월초교입구 사거리 대여소&target=bicycle
706,712,200,132,3416,4233,68,-817,1,0.204819277,신정네거리역,강월초교입구 사거리,http://map.daum.net/?sName=신정네거리역 대여소&eName=강월초교입구 사거리 대여소&target=bicycle
1668,1702,198,64,6898,6607,134,291,2,0.511450382,중계역 6번출구,녹천역 1번출구 앞,http://map.daum.net/?sName=중계역 6번출구 대여소&eName=녹천역 1번출구 앞 대여소&target=bicycle
1668,1670,89,181,6898,6607,-92,291,1,0.340740741,중계역 6번출구,노원경찰서교차로,http://map.daum.net/?sName=중계역 6번출구 대여소&eName=노원경찰서교차로 대여소&target=bicycle
1608,1670,109,185,12481,13942,-76,-1461,1,0.258503401,공릉역 1번 출구 앞,노원경찰서교차로,http://map.daum.net/?sName=공릉역 1번 출구 앞 대여소&eName=노원경찰서교차로 대여소&target=bicycle
173,367,89,275,5284,5135,-186,149,3,0.510989011,서대문역 8번출구 앞,독립문역 3-1번출구,http://map.daum.net/?sName=서대문역 8번출구 앞 대여소&eName=독립문역 3-1번출구 대여소&target=bicycle
173,308,177,88,5284,5135,89,149,1,0.335849057,서대문역 8번출구 앞,광화문 S타워 앞,http://map.daum.net/?sName=서대문역 8번출구 앞 대여소&eName=광화문 S타워 앞 대여소&target=bicycle
1608,1619,66,203,12481,13942,-137,-1461,2,0.50929368,공릉역 1번 출구 앞,중계동 하나프라자빌딩 앞(중1-1),http://map.daum.net/?sName=공릉역 1번 출구 앞 대여소&eName=중계동 하나프라자빌딩 앞(중1-1) 대여소&target=bicycle
1611,1619,129,200,10842,11015,-71,-173,1,0.215805471,과기대 입구(우),중계동 하나프라자빌딩 앞(중1-1),http://map.daum.net/?sName=과기대 입구(우) 대여소&eName=중계동 하나프라자빌딩 앞(중1-1) 대여소&target=bicycle
1608,1640,243,129,12481,13942,114,-1461,2,0.306451613,공릉역 1번 출구 앞,한내근린공원 북측,http://map.daum.net/?sName=공릉역 1번 출구 앞 대여소&eName=한내근린공원 북측 대여소&target=bicycle
1606,1640,74,128,7201,7671,-54,-470,1,0.267326733,태릉입구역 3번출구,한내근린공원 북측,http://map.daum.net/?sName=태릉입구역 3번출구 대여소&eName=한내근린공원 북측 대여소&target=bicycle
1332,1640,132,76,4977,5568,56,-591,1,0.269230769,석계역 5번출구 건너편,한내근린공원 북측,http://map.daum.net/?sName=석계역 5번출구 건너편 대여소&eName=한내근린공원 북측 대여소&target=bicycle
1608,1641,102,182,12481,13942,-80,-1461,1,0.281690141,공릉역 1번 출구 앞,한내근린공원 남측,http://map.daum.net/?sName=공릉역 1번 출구 앞 대여소&eName=한내근린공원 남측 대여소&target=bicycle
1608,1677,75,129,12481,13942,-54,-1461,1,0.264705882,공릉역 1번 출구 앞,육군사관학교  앞,http://map.daum.net/?sName=공릉역 1번 출구 앞 대여소&eName=육군사관학교  앞 대여소&target=bicycle
1608,1617,168,109,12481,13942,59,-1461,1,0.21299639,공릉역 1번 출구 앞,하계동 중평어린이공원 앞,http://map.daum.net/?sName=공릉역 1번 출구 앞 대여소&eName=하계동 중평어린이공원 앞 대여소&target=bicycle
1611,1617,143,86,10842,11015,57,-173,1,0.248908297,과기대 입구(우),하계동 중평어린이공원 앞,http://map.daum.net/?sName=과기대 입구(우) 대여소&eName=하계동 중평어린이공원 앞 대여소&target=bicycle
446,449,80,246,2313,2181,-166,132,3,0.509202454,상명대입구,일성아파트,http://map.daum.net/?sName=상명대입구 대여소&eName=일성아파트 대여소&target=bicycle
1656,1681,153,50,5683,4915,103,768,2,0.507389163,중앙하이츠 아파트 입구,현대6차 아파트,http://map.daum.net/?sName=중앙하이츠 아파트 입구 대여소&eName=현대6차 아파트 대여소&target=bicycle
1655,1681,82,146,6776,7391,-64,-615,1,0.280701754,공릉1단지아파트,현대6차 아파트,http://map.daum.net/?sName=공릉1단지아파트 대여소&eName=현대6차 아파트 대여소&target=bicycle
1625,1681,643,417,11449,11180,226,269,4,0.213207547,상계역(4번출구),현대6차 아파트,http://map.daum.net/?sName=상계역(4번출구) 대여소&eName=현대6차 아파트 대여소&target=bicycle
1656,1661,131,206,5683,4915,-75,768,1,0.222551929,중앙하이츠 아파트 입구,당현천근린공원,http://map.daum.net/?sName=중앙하이츠 아파트 입구 대여소&eName=당현천근린공원 대여소&target=bicycle
1401,1428,79,241,5610,6371,-162,-761,3,0.50625,극동늘푸른아파트,원묵고등학교,http://map.daum.net/?sName=극동늘푸른아파트 대여소&eName=원묵고등학교 대여소&target=bicycle
1407,1428,149,317,3707,4415,-168,-708,3,0.360515021,먹골역 1번출구 뒤,원묵고등학교,http://map.daum.net/?sName=먹골역 1번출구 뒤 대여소&eName=원묵고등학교 대여소&target=bicycle
1413,1428,74,131,3021,3626,-57,-605,1,0.27804878,봉화산역 5번출구 뒤,원묵고등학교,http://map.daum.net/?sName=봉화산역 5번출구 뒤 대여소&eName=원묵고등학교 대여소&target=bicycle
1401,1438,76,142,5610,6371,-66,-761,1,0.302752294,극동늘푸른아파트,홈플러스 신내점 앞,http://map.daum.net/?sName=극동늘푸른아파트 대여소&eName=홈플러스 신내점 앞 대여소&target=bicycle
1428,1438,144,77,3701,2656,67,1045,1,0.303167421,원묵고등학교,홈플러스 신내점 앞,http://map.daum.net/?sName=원묵고등학교 대여소&eName=홈플러스 신내점 앞 대여소&target=bicycle
1401,1601,96,148,5610,6371,-52,-761,1,0.213114754,극동늘푸른아파트,석계역 문화광장 내 자전거 보관소,http://map.daum.net/?sName=극동늘푸른아파트 대여소&eName=석계역 문화광장 내 자전거 보관소 대여소&target=bicycle
1332,1601,101,165,4977,5568,-64,-591,1,0.240601504,석계역 5번출구 건너편,석계역 문화광장 내 자전거 보관소,http://map.daum.net/?sName=석계역 5번출구 건너편 대여소&eName=석계역 문화광장 내 자전거 보관소 대여소&target=bicycle
183,192,136,73,15895,15355,63,540,1,0.301435407,하늘채코오롱아파트 건너편,연서어린이공원,http://map.daum.net/?sName=하늘채코오롱아파트 건너편 대여소&eName=연서어린이공원 대여소&target=bicycle
110,192,214,77,4254,3058,137,1196,2,0.470790378,사천교,연서어린이공원,http://map.daum.net/?sName=사천교 대여소&eName=연서어린이공원 대여소&target=bicycle
117,192,128,73,10247,10327,55,-80,1,0.273631841,홍은사거리,연서어린이공원,http://map.daum.net/?sName=홍은사거리 대여소&eName=연서어린이공원 대여소&target=bicycle
155,192,103,184,6617,6684,-81,-67,1,0.282229965,가좌역1 번출구 뒤,연서어린이공원,http://map.daum.net/?sName=가좌역1 번출구 뒤 대여소&eName=연서어린이공원 대여소&target=bicycle
147,202,79,240,9441,11290,-161,-1849,3,0.504702194,마포역 4번출구 뒤,국민일보 앞,http://map.daum.net/?sName=마포역 4번출구 뒤 대여소&eName=국민일보 앞 대여소&target=bicycle
2002,202,208,126,15126,17605,82,-2479,1,0.245508982,노들역 1번출구,국민일보 앞,http://map.daum.net/?sName=노들역 1번출구 대여소&eName=국민일보 앞 대여소&target=bicycle
147,210,254,416,9441,11290,-162,-1849,3,0.241791045,마포역 4번출구 뒤,IFC몰,http://map.daum.net/?sName=마포역 4번출구 뒤 대여소&eName=IFC몰 대여소&target=bicycle
146,210,301,184,10914,11574,117,-660,2,0.241237113,마포역 1번출구 뒤,IFC몰,http://map.daum.net/?sName=마포역 1번출구 뒤 대여소&eName=IFC몰 대여소&target=bicycle
142,157,733,243,4788,4640,490,148,9,0.50204918,아현역 4번출구 앞,애오개역 4번출구 앞,http://map.daum.net/?sName=아현역 4번출구 앞 대여소&eName=애오개역 4번출구 앞 대여소&target=bicycle
146,157,202,425,10914,11574,-223,-660,4,0.355661882,마포역 1번출구 뒤,애오개역 4번출구 앞,http://map.daum.net/?sName=마포역 1번출구 뒤 대여소&eName=애오개역 4번출구 앞 대여소&target=bicycle
143,157,279,445,6109,6639,-166,-530,3,0.229281768,공덕역 2번출구,애오개역 4번출구 앞,http://map.daum.net/?sName=공덕역 2번출구 대여소&eName=애오개역 4번출구 앞 대여소&target=bicycle
142,180,80,211,4788,4640,-131,148,2,0.450171821,아현역 4번출구 앞,충정로역 7번출구 뒤,http://map.daum.net/?sName=아현역 4번출구 앞 대여소&eName=충정로역 7번출구 뒤 대여소&target=bicycle
160,180,164,103,3316,2639,61,677,1,0.228464419,북아현동 가구거리,충정로역 7번출구 뒤,http://map.daum.net/?sName=북아현동 가구거리 대여소&eName=충정로역 7번출구 뒤 대여소&target=bicycle
142,156,341,136,4788,4640,205,148,4,0.429769392,아현역 4번출구 앞,서울서부지방법원 앞,http://map.daum.net/?sName=아현역 4번출구 앞 대여소&eName=서울서부지방법원 앞 대여소&target=bicycle
146,156,120,258,10914,11574,-138,-660,2,0.365079365,마포역 1번출구 뒤,서울서부지방법원 앞,http://map.daum.net/?sName=마포역 1번출구 뒤 대여소&eName=서울서부지방법원 앞 대여소&target=bicycle
142,145,240,109,4788,4640,131,148,2,0.375358166,아현역 4번출구 앞,공덕역 5번출구,http://map.daum.net/?sName=아현역 4번출구 앞 대여소&eName=공덕역 5번출구 대여소&target=bicycle
124,145,95,148,7757,6792,-53,965,1,0.218106996,서강대 정문 건너편,공덕역 5번출구,http://map.daum.net/?sName=서강대 정문 건너편 대여소&eName=공덕역 5번출구 대여소&target=bicycle
142,143,199,112,4788,4640,87,148,1,0.279742765,아현역 4번출구 앞,공덕역 2번출구,http://map.daum.net/?sName=아현역 4번출구 앞 대여소&eName=공덕역 2번출구 대여소&target=bicycle
124,143,174,115,7757,6792,59,965,1,0.204152249,서강대 정문 건너편,공덕역 2번출구,http://map.daum.net/?sName=서강대 정문 건너편 대여소&eName=공덕역 2번출구 대여소&target=bicycle
211,221,139,215,12700,11273,-76,1427,1,0.214689266,여의도역 4번출구 옆,여의도초교 앞,http://map.daum.net/?sName=여의도역 4번출구 옆 대여소&eName=여의도초교 앞 대여소&target=bicycle
220,221,178,61,7551,4988,117,2563,2,0.489539749,미성아파트 A동 앞,여의도초교 앞,http://map.daum.net/?sName=미성아파트 A동 앞 대여소&eName=여의도초교 앞 대여소&target=bicycle
216,221,182,79,6399,6478,103,-79,2,0.394636015,삼부아파트1동 앞,여의도초교 앞,http://map.daum.net/?sName=삼부아파트1동 앞 대여소&eName=여의도초교 앞 대여소&target=bicycle
300,320,203,68,6116,5344,135,772,2,0.498154982,정동사거리,을지로입구역 4번출구 앞,http://map.daum.net/?sName=정동사거리 대여소&eName=을지로입구역 4번출구 앞 대여소&target=bicycle
301,320,148,93,7911,6220,55,1691,1,0.228215768,경복궁역 7번출구 앞,을지로입구역 4번출구 앞,http://map.daum.net/?sName=경복궁역 7번출구 앞 대여소&eName=을지로입구역 4번출구 앞 대여소&target=bicycle
300,309,313,168,6116,5344,145,772,2,0.301455301,정동사거리,광화문역 6번출구 옆,http://map.daum.net/?sName=정동사거리 대여소&eName=광화문역 6번출구 옆 대여소&target=bicycle
300,348,97,160,6116,5344,-63,772,1,0.245136187,정동사거리,독립문역 사거리,http://map.daum.net/?sName=정동사거리 대여소&eName=독립문역 사거리 대여소&target=bicycle
623,624,508,172,10901,6644,336,4257,6,0.494117647,서울시립대 정문 앞,전농동 동아아파트 앞,http://map.daum.net/?sName=서울시립대 정문 앞 대여소&eName=전농동 동아아파트 앞 대여소&target=bicycle
568,624,156,83,11749,12342,73,-593,1,0.305439331,청계8가사거리 부근,전농동 동아아파트 앞,http://map.daum.net/?sName=청계8가사거리 부근 대여소&eName=전농동 동아아파트 앞 대여소&target=bicycle
583,624,94,162,15328,15747,-68,-419,1,0.265625,청계천 생태교실 앞,전농동 동아아파트 앞,http://map.daum.net/?sName=청계천 생태교실 앞 대여소&eName=전농동 동아아파트 앞 대여소&target=bicycle
610,624,202,118,3172,3062,84,110,1,0.2625,동대문중 교차로,전농동 동아아파트 앞,http://map.daum.net/?sName=동대문중 교차로 대여소&eName=전농동 동아아파트 앞 대여소&target=bicycle
623,633,290,127,10901,6644,163,4257,3,0.39088729,서울시립대 정문 앞,청량리 기업은행 앞,http://map.daum.net/?sName=서울시립대 정문 앞 대여소&eName=청량리 기업은행 앞 대여소&target=bicycle
623,635,354,198,10901,6644,156,4257,3,0.282608696,서울시립대 정문 앞,시조사 앞 (청량고정문 옆),http://map.daum.net/?sName=서울시립대 정문 앞 대여소&eName=시조사 앞 (청량고정문 옆) 대여소&target=bicycle
622,635,94,185,5324,6318,-91,-994,1,0.326164875,전농사거리 교통섬,시조사 앞 (청량고정문 옆),http://map.daum.net/?sName=전농사거리 교통섬 대여소&eName=시조사 앞 (청량고정문 옆) 대여소&target=bicycle
615,635,111,176,5962,6070,-65,-108,1,0.226480836,용두동 레미안허브리츠아파트 앞,시조사 앞 (청량고정문 옆),http://map.daum.net/?sName=용두동 레미안허브리츠아파트 앞 대여소&eName=시조사 앞 (청량고정문 옆) 대여소&target=bicycle
624,635,73,127,6128,8212,-54,-2084,1,0.27,전농동 동아아파트 앞,시조사 앞 (청량고정문 옆),http://map.daum.net/?sName=전농동 동아아파트 앞 대여소&eName=시조사 앞 (청량고정문 옆) 대여소&target=bicycle
623,634,264,175,10901,6644,89,4257,1,0.202733485,서울시립대 정문 앞,외국어대 정문 앞,http://map.daum.net/?sName=서울시립대 정문 앞 대여소&eName=외국어대 정문 앞 대여소&target=bicycle
627,634,203,79,4782,5352,124,-570,2,0.439716312,장안동삼거리 교통섬,외국어대 정문 앞,http://map.daum.net/?sName=장안동삼거리 교통섬 대여소&eName=외국어대 정문 앞 대여소&target=bicycle
1321,634,94,146,7607,7623,-52,-16,1,0.216666667,국민은행 종암동지점 앞,외국어대 정문 앞,http://map.daum.net/?sName=국민은행 종암동지점 앞 대여소&eName=외국어대 정문 앞 대여소&target=bicycle
1448,634,214,140,7251,7472,74,-221,1,0.209039548,코스트코 상봉점,외국어대 정문 앞,http://map.daum.net/?sName=코스트코 상봉점 대여소&eName=외국어대 정문 앞 대여소&target=bicycle
1333,634,199,312,4398,5241,-113,-843,2,0.221135029,석관초등학교 앞,외국어대 정문 앞,http://map.daum.net/?sName=석관초등학교 앞 대여소&eName=외국어대 정문 앞 대여소&target=bicycle
1433,634,109,181,6019,7296,-72,-1277,1,0.248275862,중화역 2번출구,외국어대 정문 앞,http://map.daum.net/?sName=중화역 2번출구 대여소&eName=외국어대 정문 앞 대여소&target=bicycle
1451,634,307,186,5613,6523,121,-910,2,0.245436105,중랑세무서,외국어대 정문 앞,http://map.daum.net/?sName=중랑세무서 대여소&eName=외국어대 정문 앞 대여소&target=bicycle
576,591,171,58,5056,5403,113,-347,2,0.493449782,광나루역 3번 출구,건국대학교 (행정관),http://map.daum.net/?sName=광나루역 3번 출구 대여소&eName=건국대학교 (행정관) 대여소&target=bicycle
3520,591,189,106,7586,7409,83,177,1,0.281355932,광진경찰서,건국대학교 (행정관),http://map.daum.net/?sName=광진경찰서 대여소&eName=건국대학교 (행정관) 대여소&target=bicycle
622,623,186,548,5324,6318,-362,-994,7,0.493188011,전농사거리 교통섬,서울시립대 정문 앞,http://map.daum.net/?sName=전농사거리 교통섬 대여소&eName=서울시립대 정문 앞 대여소&target=bicycle
617,623,223,369,4018,4981,-146,-963,2,0.246621622,청솔우성아파트 앞,서울시립대 정문 앞,http://map.daum.net/?sName=청솔우성아파트 앞 대여소&eName=서울시립대 정문 앞 대여소&target=bicycle
1814,1911,55,162,3291,3394,-107,-103,2,0.493087558,두산위브아파트 옆 상가건물 앞,구로디지털단지역 앞,http://map.daum.net/?sName=두산위브아파트 옆 상가건물 앞 대여소&eName=구로디지털단지역 앞 대여소&target=bicycle
1911,1924,153,449,14800,15147,-296,-347,5,0.491694352,구로디지털단지역 앞,삼부르네상스파크빌,http://map.daum.net/?sName=구로디지털단지역 앞 대여소&eName=삼부르네상스파크빌 대여소&target=bicycle
1911,1920,73,158,14800,15147,-85,-347,1,0.367965368,구로디지털단지역 앞,서울미래초등학교 사거리,http://map.daum.net/?sName=구로디지털단지역 앞 대여소&eName=서울미래초등학교 사거리 대여소&target=bicycle
1911,263,149,322,14800,15147,-173,-347,3,0.367303609,구로디지털단지역 앞,근로자회관 사거리,http://map.daum.net/?sName=구로디지털단지역 앞 대여소&eName=근로자회관 사거리 대여소&target=bicycle
1911,2109,167,99,14800,15147,68,-347,1,0.255639098,구로디지털단지역 앞,은천로입구 가로공원,http://map.daum.net/?sName=구로디지털단지역 앞 대여소&eName=은천로입구 가로공원 대여소&target=bicycle
1911,703,152,94,14800,15147,58,-347,1,0.235772358,구로디지털단지역 앞,오목교역 7번출구 앞,http://map.daum.net/?sName=구로디지털단지역 앞 대여소&eName=오목교역 7번출구 앞 대여소&target=bicycle
700,703,157,100,8811,9254,57,-443,1,0.221789883,KB국민은행 염창역 지점 앞,오목교역 7번출구 앞,http://map.daum.net/?sName=KB국민은행 염창역 지점 앞 대여소&eName=오목교역 7번출구 앞 대여소&target=bicycle
1141,703,172,275,4548,6676,-103,-2128,2,0.230425056,곰달래 문화복지센터 1-1,오목교역 7번출구 앞,http://map.daum.net/?sName=곰달래 문화복지센터 1-1 대여소&eName=오목교역 7번출구 앞 대여소&target=bicycle
1904,703,181,91,6583,6202,90,381,1,0.330882353,도림천역 1번 출구 앞,오목교역 7번출구 앞,http://map.daum.net/?sName=도림천역 1번 출구 앞 대여소&eName=오목교역 7번출구 앞 대여소&target=bicycle
320,326,57,167,8938,8663,-110,275,2,0.491071429,을지로입구역 4번출구 앞,안국역 5번출구 앞,http://map.daum.net/?sName=을지로입구역 4번출구 앞 대여소&eName=안국역 5번출구 앞 대여소&target=bicycle
322,326,142,68,4381,3221,74,1160,1,0.352380952,명동성당 앞,안국역 5번출구 앞,http://map.daum.net/?sName=명동성당 앞 대여소&eName=안국역 5번출구 앞 대여소&target=bicycle
320,368,266,123,8938,8663,143,275,2,0.367609254,을지로입구역 4번출구 앞,SK 서린빌딩 앞,http://map.daum.net/?sName=을지로입구역 4번출구 앞 대여소&eName=SK 서린빌딩 앞 대여소&target=bicycle
327,368,162,108,7393,6943,54,450,1,0.2,낙원상가 옆,SK 서린빌딩 앞,http://map.daum.net/?sName=낙원상가 옆 대여소&eName=SK 서린빌딩 앞 대여소&target=bicycle
301,368,137,79,7911,6220,58,1691,1,0.268518519,경복궁역 7번출구 앞,SK 서린빌딩 앞,http://map.daum.net/?sName=경복궁역 7번출구 앞 대여소&eName=SK 서린빌딩 앞 대여소&target=bicycle
320,327,160,306,8938,8663,-146,275,2,0.313304721,을지로입구역 4번출구 앞,낙원상가 옆,http://map.daum.net/?sName=을지로입구역 4번출구 앞 대여소&eName=낙원상가 옆 대여소&target=bicycle
314,327,248,126,7832,7432,122,400,2,0.326203209,국립현대미술관,낙원상가 옆,http://map.daum.net/?sName=국립현대미술관 대여소&eName=낙원상가 옆 대여소&target=bicycle
301,327,239,121,7911,6220,118,1691,2,0.327777778,경복궁역 7번출구 앞,낙원상가 옆,http://map.daum.net/?sName=경복궁역 7번출구 앞 대여소&eName=낙원상가 옆 대여소&target=bicycle
316,327,387,665,9851,9225,-278,626,5,0.264258555,종각역 1번출구 앞,낙원상가 옆,http://map.daum.net/?sName=종각역 1번출구 앞 대여소&eName=낙원상가 옆 대여소&target=bicycle
320,324,149,88,8938,8663,61,275,1,0.257383966,을지로입구역 4번출구 앞,신세계백화점 본점 앞,http://map.daum.net/?sName=을지로입구역 4번출구 앞 대여소&eName=신세계백화점 본점 앞 대여소&target=bicycle
220,250,164,79,7551,4988,85,2563,1,0.349794239,미성아파트 A동 앞,대림아파트 사거리,http://map.daum.net/?sName=미성아파트 A동 앞 대여소&eName=대림아파트 사거리 대여소&target=bicycle
416,421,420,144,5281,2301,276,2980,5,0.489361702,상암월드컵파크 1단지 교차로,마포구청 앞,http://map.daum.net/?sName=상암월드컵파크 1단지 교차로 대여소&eName=마포구청 앞 대여소&target=bicycle
184,421,497,316,7878,7950,181,-72,3,0.222632226,SK망원동주유소 건너편,마포구청 앞,http://map.daum.net/?sName=SK망원동주유소 건너편 대여소&eName=마포구청 앞 대여소&target=bicycle
117,421,219,125,10247,10327,94,-80,1,0.273255814,홍은사거리,마포구청 앞,http://map.daum.net/?sName=홍은사거리 대여소&eName=마포구청 앞 대여소&target=bicycle
417,421,182,111,8832,6175,71,2657,1,0.242320819,DMC역 2번출구 옆,마포구청 앞,http://map.daum.net/?sName=DMC역 2번출구 옆 대여소&eName=마포구청 앞 대여소&target=bicycle
413,421,321,180,3693,2842,141,851,2,0.281437126,상암월드컵파크 3단지 후문,마포구청 앞,http://map.daum.net/?sName=상암월드컵파크 3단지 후문 대여소&eName=마포구청 앞 대여소&target=bicycle
418,421,194,129,11442,11253,65,189,1,0.20123839,월드컵경기장역 3번출구 옆,마포구청 앞,http://map.daum.net/?sName=월드컵경기장역 3번출구 옆 대여소&eName=마포구청 앞 대여소&target=bicycle
416,427,181,66,5281,2301,115,2980,2,0.465587045,상암월드컵파크 1단지 교차로,성산시영아파트,http://map.daum.net/?sName=상암월드컵파크 1단지 교차로 대여소&eName=성산시영아파트 대여소&target=bicycle
416,418,510,226,5281,2301,284,2980,5,0.385869565,상암월드컵파크 1단지 교차로,월드컵경기장역 3번출구 옆,http://map.daum.net/?sName=상암월드컵파크 1단지 교차로 대여소&eName=월드컵경기장역 3번출구 옆 대여소&target=bicycle
417,418,164,85,8832,6175,79,2657,1,0.317269076,DMC역 2번출구 옆,월드컵경기장역 3번출구 옆,http://map.daum.net/?sName=DMC역 2번출구 옆 대여소&eName=월드컵경기장역 3번출구 옆 대여소&target=bicycle
186,418,127,247,9655,10165,-120,-510,2,0.320855615,월드컵공원,월드컵경기장역 3번출구 옆,http://map.daum.net/?sName=월드컵공원 대여소&eName=월드컵경기장역 3번출구 옆 대여소&target=bicycle
413,418,515,319,3693,2842,196,851,3,0.23501199,상암월드컵파크 3단지 후문,월드컵경기장역 3번출구 옆,http://map.daum.net/?sName=상암월드컵파크 3단지 후문 대여소&eName=월드컵경기장역 3번출구 옆 대여소&target=bicycle
1230,1271,300,103,3675,2883,197,792,3,0.488833747,송파중학교 정문,송파도서관,http://map.daum.net/?sName=송파중학교 정문 대여소&eName=송파도서관 대여소&target=bicycle
1230,1256,178,87,3675,2883,91,792,1,0.343396226,송파중학교 정문,문정현대아파트 교차로,http://map.daum.net/?sName=송파중학교 정문 대여소&eName=문정현대아파트 교차로 대여소&target=bicycle
1201,1256,102,229,6406,7066,-127,-660,2,0.383685801,가락시장역 3번 출구,문정현대아파트 교차로,http://map.daum.net/?sName=가락시장역 3번 출구 대여소&eName=문정현대아파트 교차로 대여소&target=bicycle
132,140,83,172,6680,6284,-89,396,1,0.349019608,창천문화공원,이화여대 후문,http://map.daum.net/?sName=창천문화공원 대여소&eName=이화여대 후문 대여소&target=bicycle
700,735,188,65,8811,9254,123,-443,2,0.486166008,KB국민은행 염창역 지점 앞,영도초등학교,http://map.daum.net/?sName=KB국민은행 염창역 지점 앞 대여소&eName=영도초등학교 대여소&target=bicycle
706,707,53,153,3416,4233,-100,-817,2,0.485436893,신정네거리역,신정3동주민센터,http://map.daum.net/?sName=신정네거리역 대여소&eName=신정3동주민센터 대여소&target=bicycle
706,736,265,130,3416,4233,135,-817,2,0.341772152,신정네거리역,오솔길공원,http://map.daum.net/?sName=신정네거리역 대여소&eName=오솔길공원 대여소&target=bicycle
710,736,229,107,1956,2030,122,-74,2,0.363095238,서부화물트럭터미널 사거리,오솔길공원,http://map.daum.net/?sName=서부화물트럭터미널 사거리 대여소&eName=오솔길공원 대여소&target=bicycle
1619,1655,150,52,7475,7547,98,-72,1,0.485148515,중계동 하나프라자빌딩 앞(중1-1),공릉1단지아파트,http://map.daum.net/?sName=중계동 하나프라자빌딩 앞(중1-1) 대여소&eName=공릉1단지아파트 대여소&target=bicycle
1619,1623,391,251,7475,7547,140,-72,2,0.218068536,중계동 하나프라자빌딩 앞(중1-1),노원 구민회관,http://map.daum.net/?sName=중계동 하나프라자빌딩 앞(중1-1) 대여소&eName=노원 구민회관 대여소&target=bicycle
1605,1623,102,177,3705,4403,-75,-698,1,0.268817204,헬스케어,노원 구민회관,http://map.daum.net/?sName=헬스케어 대여소&eName=노원 구민회관 대여소&target=bicycle
1619,1656,220,339,7475,7547,-119,-72,2,0.212880143,중계동 하나프라자빌딩 앞(중1-1),중앙하이츠 아파트 입구,http://map.daum.net/?sName=중계동 하나프라자빌딩 앞(중1-1) 대여소&eName=중앙하이츠 아파트 입구 대여소&target=bicycle
1625,1656,179,271,11449,11180,-92,269,1,0.204444444,상계역(4번출구),중앙하이츠 아파트 입구,http://map.daum.net/?sName=상계역(4번출구) 대여소&eName=중앙하이츠 아파트 입구 대여소&target=bicycle
1619,1625,509,769,7475,7547,-260,-72,5,0.203442879,중계동 하나프라자빌딩 앞(중1-1),상계역(4번출구),http://map.daum.net/?sName=중계동 하나프라자빌딩 앞(중1-1) 대여소&eName=상계역(4번출구) 대여소&target=bicycle
1925,229,63,179,10853,11258,-116,-405,2,0.479338843,동양미래대학교 정문 옆,양평1 보행육교 앞,http://map.daum.net/?sName=동양미래대학교 정문 옆 대여소&eName=양평1 보행육교 앞 대여소&target=bicycle
1925,1957,182,93,10853,11258,89,-405,1,0.323636364,동양미래대학교 정문 옆,구일고등학교 정문,http://map.daum.net/?sName=동양미래대학교 정문 옆 대여소&eName=구일고등학교 정문 대여소&target=bicycle
1925,1946,164,247,10853,11258,-83,-405,1,0.201946472,동양미래대학교 정문 옆,구로역 광장,http://map.daum.net/?sName=동양미래대학교 정문 옆 대여소&eName=구로역 광장 대여소&target=bicycle
1901,1946,140,217,3793,4187,-77,-394,1,0.215686275,신도림동주민센터 앞,구로역 광장,http://map.daum.net/?sName=신도림동주민센터 앞 대여소&eName=구로역 광장 대여소&target=bicycle
907,930,65,138,17334,21700,-73,-4366,1,0.359605911,CJ 드림시티,구 서부경찰서 건너편,http://map.daum.net/?sName=CJ 드림시티 대여소&eName=구 서부경찰서 건너편 대여소&target=bicycle
907,935,244,373,17334,21700,-129,-4366,2,0.209076175,CJ 드림시티,역촌역 1번 출구,http://map.daum.net/?sName=CJ 드림시티 대여소&eName=역촌역 1번 출구 대여소&target=bicycle
926,935,270,151,6546,6833,119,-287,2,0.282660333,불광역 8번출구,역촌역 1번 출구,http://map.daum.net/?sName=불광역 8번출구 대여소&eName=역촌역 1번 출구 대여소&target=bicycle
1308,3513,86,244,21816,23730,-158,-1914,3,0.478787879,안암로터리 버스정류장 앞,상왕십리역 1번출구,http://map.daum.net/?sName=안암로터리 버스정류장 앞 대여소&eName=상왕십리역 1번출구 대여소&target=bicycle
1308,345,137,71,21816,23730,66,-1914,1,0.317307692,안암로터리 버스정류장 앞,서울보증보험본사 앞,http://map.daum.net/?sName=안암로터리 버스정류장 앞 대여소&eName=서울보증보험본사 앞 대여소&target=bicycle
341,345,337,170,6944,6197,167,747,3,0.32938856,혜화역 3번출구 뒤,서울보증보험본사 앞,http://map.daum.net/?sName=혜화역 3번출구 뒤 대여소&eName=서울보증보험본사 앞 대여소&target=bicycle
334,345,175,263,10121,9952,-88,169,1,0.200913242,종로3가역 2번출구 뒤,서울보증보험본사 앞,http://map.daum.net/?sName=종로3가역 2번출구 뒤 대여소&eName=서울보증보험본사 앞 대여소&target=bicycle
1308,519,109,190,21816,23730,-81,-1914,1,0.27090301,안암로터리 버스정류장 앞,양지사거리,http://map.daum.net/?sName=안암로터리 버스정류장 앞 대여소&eName=양지사거리 대여소&target=bicycle
3513,519,200,99,7483,4882,101,2601,2,0.337792642,상왕십리역 1번출구,양지사거리,http://map.daum.net/?sName=상왕십리역 1번출구 대여소&eName=양지사거리 대여소&target=bicycle
378,519,87,186,7304,7234,-99,70,1,0.362637363,청계7가 사거리,양지사거리,http://map.daum.net/?sName=청계7가 사거리 대여소&eName=양지사거리 대여소&target=bicycle
1308,362,437,285,21816,23730,152,-1914,3,0.210526316,안암로터리 버스정류장 앞,청계8가 사거리,http://map.daum.net/?sName=안암로터리 버스정류장 앞 대여소&eName=청계8가 사거리 대여소&target=bicycle
158,312,187,66,3964,4028,121,-64,2,0.47826087,독립문 어린이 공원,시청역 1번출구 뒤,http://map.daum.net/?sName=독립문 어린이 공원 대여소&eName=시청역 1번출구 뒤 대여소&target=bicycle
309,312,302,182,5992,4473,120,1519,2,0.247933884,광화문역 6번출구 옆,시청역 1번출구 뒤,http://map.daum.net/?sName=광화문역 6번출구 옆 대여소&eName=시청역 1번출구 뒤 대여소&target=bicycle
158,173,171,98,3964,4028,73,-64,1,0.271375465,독립문 어린이 공원,서대문역 8번출구 앞,http://map.daum.net/?sName=독립문 어린이 공원 대여소&eName=서대문역 8번출구 앞 대여소&target=bicycle
1231,1262,148,53,12608,12435,95,173,1,0.472636816,잠실역 6번출구,송파여성문화회관 앞,http://map.daum.net/?sName=잠실역 6번출구 대여소&eName=송파여성문화회관 앞 대여소&target=bicycle
1260,1262,160,101,5496,5493,59,3,1,0.22605364,방이동 한양3차아파트 옆,송파여성문화회관 앞,http://map.daum.net/?sName=방이동 한양3차아파트 옆 대여소&eName=송파여성문화회관 앞 대여소&target=bicycle
1231,542,67,149,12608,12435,-82,173,1,0.37962963,잠실역 6번출구,강변역 4번출구 뒤,http://map.daum.net/?sName=잠실역 6번출구 대여소&eName=강변역 4번출구 뒤 대여소&target=bicycle
1210,542,159,96,27973,28094,63,-121,1,0.247058824,롯데월드타워(잠실역2번출구 쪽),강변역 4번출구 뒤,http://map.daum.net/?sName=롯데월드타워(잠실역2번출구 쪽) 대여소&eName=강변역 4번출구 뒤 대여소&target=bicycle
1222,542,136,82,19141,19511,54,-370,1,0.247706422,잠실새내역 5번 출구 뒤,강변역 4번출구 뒤,http://map.daum.net/?sName=잠실새내역 5번 출구 뒤 대여소&eName=강변역 4번출구 뒤 대여소&target=bicycle
1231,502,186,396,12608,12435,-210,173,4,0.360824742,잠실역 6번출구,뚝섬유원지역 1번출구 앞,http://map.daum.net/?sName=잠실역 6번출구 대여소&eName=뚝섬유원지역 1번출구 앞 대여소&target=bicycle
1209,502,108,206,14401,14405,-98,-4,1,0.312101911,잠실나루역 (2번 출구 쪽),뚝섬유원지역 1번출구 앞,http://map.daum.net/?sName=잠실나루역 (2번 출구 쪽) 대여소&eName=뚝섬유원지역 1번출구 앞 대여소&target=bicycle
2219,502,144,240,26414,27015,-96,-601,1,0.25,"고속터미널역 8-1번, 8-2번 출구 사이",뚝섬유원지역 1번출구 앞,"http://map.daum.net/?sName=고속터미널역 8-1번, 8-2번 출구 사이 대여소&eName=뚝섬유원지역 1번출구 앞 대여소&target=bicycle"
3515,502,565,266,11085,11260,299,-175,5,0.359807461,서울숲 관리사무소,뚝섬유원지역 1번출구 앞,http://map.daum.net/?sName=서울숲 관리사무소 대여소&eName=뚝섬유원지역 1번출구 앞 대여소&target=bicycle
3505,502,673,365,5644,4650,308,994,6,0.29672447,신양초교앞 교차로,뚝섬유원지역 1번출구 앞,http://map.daum.net/?sName=신양초교앞 교차로 대여소&eName=뚝섬유원지역 1번출구 앞 대여소&target=bicycle
1210,502,243,162,27973,28094,81,-121,1,0.2,롯데월드타워(잠실역2번출구 쪽),뚝섬유원지역 1번출구 앞,http://map.daum.net/?sName=롯데월드타워(잠실역2번출구 쪽) 대여소&eName=뚝섬유원지역 1번출구 앞 대여소&target=bicycle
3506,502,324,526,3956,4320,-202,-364,4,0.237647059,영동대교 북단,뚝섬유원지역 1번출구 앞,http://map.daum.net/?sName=영동대교 북단 대여소&eName=뚝섬유원지역 1번출구 앞 대여소&target=bicycle
1231,1251,243,125,12608,12435,118,173,2,0.320652174,잠실역 6번출구,석촌역 2번출구,http://map.daum.net/?sName=잠실역 6번출구 대여소&eName=석촌역 2번출구 대여소&target=bicycle
1220,1251,82,168,6741,7523,-86,-782,1,0.344,잠실본동주민센터뒤 잠실근린공원,석촌역 2번출구,http://map.daum.net/?sName=잠실본동주민센터뒤 잠실근린공원 대여소&eName=석촌역 2번출구 대여소&target=bicycle
1221,1251,144,303,8629,11466,-159,-2837,3,0.355704698,삼전사거리 포스코더샵,석촌역 2번출구,http://map.daum.net/?sName=삼전사거리 포스코더샵 대여소&eName=석촌역 2번출구 대여소&target=bicycle
1245,1251,82,142,7098,6848,-60,250,1,0.267857143,문정 법조단지9,석촌역 2번출구,http://map.daum.net/?sName=문정 법조단지9 대여소&eName=석촌역 2번출구 대여소&target=bicycle
1231,501,83,150,12608,12435,-67,173,1,0.287553648,잠실역 6번출구,광진구의회 앞,http://map.daum.net/?sName=잠실역 6번출구 대여소&eName=광진구의회 앞 대여소&target=bicycle
3505,501,281,135,5644,4650,146,994,2,0.350961538,신양초교앞 교차로,광진구의회 앞,http://map.daum.net/?sName=신양초교앞 교차로 대여소&eName=광진구의회 앞 대여소&target=bicycle
1231,2219,73,131,12608,12435,-58,173,1,0.284313725,잠실역 6번출구,"고속터미널역 8-1번, 8-2번 출구 사이","http://map.daum.net/?sName=잠실역 6번출구 대여소&eName=고속터미널역 8-1번, 8-2번 출구 사이 대여소&target=bicycle"
2213,2219,222,120,4585,3679,102,906,2,0.298245614,고속터미널역 5번출구 앞,"고속터미널역 8-1번, 8-2번 출구 사이","http://map.daum.net/?sName=고속터미널역 5번출구 앞 대여소&eName=고속터미널역 8-1번, 8-2번 출구 사이 대여소&target=bicycle"
2211,2219,287,169,3076,2612,118,464,2,0.25877193,서초구립반포도서관 앞,"고속터미널역 8-1번, 8-2번 출구 사이","http://map.daum.net/?sName=서초구립반포도서관 앞 대여소&eName=고속터미널역 8-1번, 8-2번 출구 사이 대여소&target=bicycle"
502,512,139,352,40455,46318,-213,-5863,4,0.433808554,뚝섬유원지역 1번출구 앞,뚝섬역 1번 출구 옆,http://map.daum.net/?sName=뚝섬유원지역 1번출구 앞 대여소&eName=뚝섬역 1번 출구 옆 대여소&target=bicycle
3522,512,121,182,7516,8547,-61,-1031,1,0.201320132,사근삼거리,뚝섬역 1번 출구 옆,http://map.daum.net/?sName=사근삼거리 대여소&eName=뚝섬역 1번 출구 옆 대여소&target=bicycle
502,511,263,597,40455,46318,-334,-5863,6,0.388372093,뚝섬유원지역 1번출구 앞,서울숲역 4번 출구 옆,http://map.daum.net/?sName=뚝섬유원지역 1번출구 앞 대여소&eName=서울숲역 4번 출구 옆 대여소&target=bicycle
502,516,132,217,40455,46318,-85,-5863,1,0.243553009,뚝섬유원지역 1번출구 앞,광진메디칼 앞,http://map.daum.net/?sName=뚝섬유원지역 1번출구 앞 대여소&eName=광진메디칼 앞 대여소&target=bicycle
514,516,76,142,11672,12181,-66,-509,1,0.302752294,성수사거리 버스정류장 앞,광진메디칼 앞,http://map.daum.net/?sName=성수사거리 버스정류장 앞 대여소&eName=광진메디칼 앞 대여소&target=bicycle
502,537,110,178,40455,46318,-68,-5863,1,0.236111111,뚝섬유원지역 1번출구 앞,한양대후문역 부근,http://map.daum.net/?sName=뚝섬유원지역 1번출구 앞 대여소&eName=한양대후문역 부근 대여소&target=bicycle
502,837,181,113,40455,46318,68,-5863,1,0.231292517,뚝섬유원지역 1번출구 앞,한남나들목 입구,http://map.daum.net/?sName=뚝섬유원지역 1번출구 앞 대여소&eName=한남나들목 입구 대여소&target=bicycle
1705,1720,403,145,4247,4398,258,-151,5,0.47080292,도봉구청 정문앞,도봉구청 옆(중랑천변),http://map.daum.net/?sName=도봉구청 정문앞 대여소&eName=도봉구청 옆(중랑천변) 대여소&target=bicycle
1706,1720,166,106,4312,5011,60,-699,1,0.220588235,기업은행 앞,도봉구청 옆(중랑천변),http://map.daum.net/?sName=기업은행 앞 대여소&eName=도봉구청 옆(중랑천변) 대여소&target=bicycle
1705,1719,86,167,4247,4398,-81,-151,1,0.320158103,도봉구청 정문앞,신도봉사거리 버스정류장,http://map.daum.net/?sName=도봉구청 정문앞 대여소&eName=신도봉사거리 버스정류장 대여소&target=bicycle
1709,1719,174,81,7817,7156,93,661,1,0.364705882,쌍문역4번출구 주변,신도봉사거리 버스정류장,http://map.daum.net/?sName=쌍문역4번출구 주변 대여소&eName=신도봉사거리 버스정류장 대여소&target=bicycle
1705,1707,76,141,4247,4398,-65,-151,1,0.299539171,도봉구청 정문앞,도봉구민회관,http://map.daum.net/?sName=도봉구청 정문앞 대여소&eName=도봉구민회관 대여소&target=bicycle
1705,1726,173,266,4247,4398,-93,-151,1,0.211845103,도봉구청 정문앞,삼익세라믹아파트교차로,http://map.daum.net/?sName=도봉구청 정문앞 대여소&eName=삼익세라믹아파트교차로 대여소&target=bicycle
1707,1726,302,130,4171,3645,172,526,3,0.398148148,도봉구민회관,삼익세라믹아파트교차로,http://map.daum.net/?sName=도봉구민회관 대여소&eName=삼익세라믹아파트교차로 대여소&target=bicycle
1721,1726,318,552,6356,6964,-234,-608,4,0.268965517,창동역 2번출구,삼익세라믹아파트교차로,http://map.daum.net/?sName=창동역 2번출구 대여소&eName=삼익세라믹아파트교차로 대여소&target=bicycle
110,113,668,244,4254,3058,424,1196,8,0.464912281,사천교,홍대입구역 2번출구 앞,http://map.daum.net/?sName=사천교 대여소&eName=홍대입구역 2번출구 앞 대여소&target=bicycle
105,113,271,171,5689,4736,100,953,2,0.226244344,합정역 5번출구 앞,홍대입구역 2번출구 앞,http://map.daum.net/?sName=합정역 5번출구 앞 대여소&eName=홍대입구역 2번출구 앞 대여소&target=bicycle
110,170,294,124,4254,3058,170,1196,3,0.406698565,사천교,가재울 뉴타운 주유소 옆,http://map.daum.net/?sName=사천교 대여소&eName=가재울 뉴타운 주유소 옆 대여소&target=bicycle
117,170,246,117,10247,10327,129,-80,2,0.355371901,홍은사거리,가재울 뉴타운 주유소 옆,http://map.daum.net/?sName=홍은사거리 대여소&eName=가재울 뉴타운 주유소 옆 대여소&target=bicycle
154,170,75,131,11278,11858,-56,-580,1,0.27184466,마포구청역,가재울 뉴타운 주유소 옆,http://map.daum.net/?sName=마포구청역 대여소&eName=가재울 뉴타운 주유소 옆 대여소&target=bicycle
110,117,82,166,4254,3058,-84,1196,1,0.338709677,사천교,홍은사거리,http://map.daum.net/?sName=사천교 대여소&eName=홍은사거리 대여소&target=bicycle
110,166,253,144,4254,3058,109,1196,2,0.274559194,사천교,가재울 초등학교,http://map.daum.net/?sName=사천교 대여소&eName=가재울 초등학교 대여소&target=bicycle
117,166,339,135,10247,10327,204,-80,4,0.430379747,홍은사거리,가재울 초등학교,http://map.daum.net/?sName=홍은사거리 대여소&eName=가재울 초등학교 대여소&target=bicycle
165,166,225,94,4944,4414,131,530,2,0.410658307,중앙근린공원,가재울 초등학교,http://map.daum.net/?sName=중앙근린공원 대여소&eName=가재울 초등학교 대여소&target=bicycle
2242,2246,198,86,6053,4265,112,1788,2,0.394366197,양재역 11번 출구 앞,서울시 품질시험소 앞,http://map.daum.net/?sName=양재역 11번 출구 앞 대여소&eName=서울시 품질시험소 앞 대여소&target=bicycle
2242,2243,139,61,6053,4265,78,1788,1,0.39,양재역 11번 출구 앞,서울가정법원,http://map.daum.net/?sName=양재역 11번 출구 앞 대여소&eName=서울가정법원 대여소&target=bicycle
2206,2243,72,172,4671,4677,-100,-6,2,0.409836066,언남초등학교 앞,서울가정법원,http://map.daum.net/?sName=언남초등학교 앞 대여소&eName=서울가정법원 대여소&target=bicycle
2242,2327,214,97,6053,4265,117,1788,2,0.376205788,양재역 11번 출구 앞,뱅뱅사거리 랜드마크타워 앞,http://map.daum.net/?sName=양재역 11번 출구 앞 대여소&eName=뱅뱅사거리 랜드마크타워 앞 대여소&target=bicycle
2242,2252,368,218,6053,4265,150,1788,3,0.255972696,양재역 11번 출구 앞,하이브랜드 앞,http://map.daum.net/?sName=양재역 11번 출구 앞 대여소&eName=하이브랜드 앞 대여소&target=bicycle
2244,2252,199,132,5404,4975,67,429,1,0.202416918,교육개발원입구 교차로,하이브랜드 앞,http://map.daum.net/?sName=교육개발원입구 교차로 대여소&eName=하이브랜드 앞 대여소&target=bicycle
2242,2255,187,118,6053,4265,69,1788,1,0.226229508,양재역 11번 출구 앞,시민의숲역 1번출구 옆,http://map.daum.net/?sName=양재역 11번 출구 앞 대여소&eName=시민의숲역 1번출구 옆 대여소&target=bicycle
2248,2255,472,266,2384,2255,206,129,4,0.279132791,서초리슈빌S 글로벌 앞,시민의숲역 1번출구 옆,http://map.daum.net/?sName=서초리슈빌S 글로벌 앞 대여소&eName=시민의숲역 1번출구 옆 대여소&target=bicycle
2250,2255,216,120,2373,2230,96,143,1,0.285714286,서초유치원 맞은편,시민의숲역 1번출구 옆,http://map.daum.net/?sName=서초유치원 맞은편 대여소&eName=시민의숲역 1번출구 옆 대여소&target=bicycle
199,420,157,57,4808,3463,100,1345,2,0.46728972,서울 월드컵 경기장,서울시 공공자전거 상암센터,http://map.daum.net/?sName=서울 월드컵 경기장 대여소&eName=서울시 공공자전거 상암센터 대여소&target=bicycle
186,420,191,354,9655,10165,-163,-510,3,0.299082569,월드컵공원,서울시 공공자전거 상암센터,http://map.daum.net/?sName=월드컵공원 대여소&eName=서울시 공공자전거 상암센터 대여소&target=bicycle
407,410,163,254,4377,4263,-91,114,1,0.21822542,마포구 육아종합지원센터,상암중학교 옆,http://map.daum.net/?sName=마포구 육아종합지원센터 대여소&eName=상암중학교 옆 대여소&target=bicycle
407,411,159,106,4377,4263,53,114,1,0.2,마포구 육아종합지원센터,DMC홍보관,http://map.daum.net/?sName=마포구 육아종합지원센터 대여소&eName=DMC홍보관 대여소&target=bicycle
402,411,287,171,5010,4687,116,323,2,0.253275109,상암월드컵파크 9단지 앞,DMC홍보관,http://map.daum.net/?sName=상암월드컵파크 9단지 앞 대여소&eName=DMC홍보관 대여소&target=bicycle
264,266,294,107,4236,3520,187,716,3,0.466334165,교보생명보험 앞,영등포청과시장 사거리,http://map.daum.net/?sName=교보생명보험 앞 대여소&eName=영등포청과시장 사거리 대여소&target=bicycle
232,266,139,222,10839,11441,-83,-602,1,0.229916898,양평우림 이비즈센타 앞,영등포청과시장 사거리,http://map.daum.net/?sName=양평우림 이비즈센타 앞 대여소&eName=영등포청과시장 사거리 대여소&target=bicycle
1201,1286,80,219,6406,7066,-139,-660,2,0.464882943,가락시장역 3번 출구,위례중앙푸르지오 1단지 앞,http://map.daum.net/?sName=가락시장역 3번 출구 대여소&eName=위례중앙푸르지오 1단지 앞 대여소&target=bicycle
1243,1286,92,177,9277,9808,-85,-531,1,0.31598513,문정 법조단지7,위례중앙푸르지오 1단지 앞,http://map.daum.net/?sName=문정 법조단지7 대여소&eName=위례중앙푸르지오 1단지 앞 대여소&target=bicycle
1217,1286,134,240,4407,4548,-106,-141,2,0.28342246,송파파인타운 7단지,위례중앙푸르지오 1단지 앞,http://map.daum.net/?sName=송파파인타운 7단지 대여소&eName=위례중앙푸르지오 1단지 앞 대여소&target=bicycle
1285,1286,197,111,2271,2238,86,33,1,0.279220779,위례별 유치원 뒤,위례중앙푸르지오 1단지 앞,http://map.daum.net/?sName=위례별 유치원 뒤 대여소&eName=위례중앙푸르지오 1단지 앞 대여소&target=bicycle
1244,1286,83,145,8508,8753,-62,-245,1,0.271929825,문정 법조단지8,위례중앙푸르지오 1단지 앞,http://map.daum.net/?sName=문정 법조단지8 대여소&eName=위례중앙푸르지오 1단지 앞 대여소&target=bicycle
1201,1217,92,213,6406,7066,-121,-660,2,0.396721311,가락시장역 3번 출구,송파파인타운 7단지,http://map.daum.net/?sName=가락시장역 3번 출구 대여소&eName=송파파인타운 7단지 대여소&target=bicycle
1201,1265,229,405,6406,7066,-176,-660,3,0.277602524,가락시장역 3번 출구,문정동 근린공원,http://map.daum.net/?sName=가락시장역 3번 출구 대여소&eName=문정동 근린공원 대여소&target=bicycle
1212,1265,157,83,6783,7281,74,-498,1,0.308333333,송파역 2번 출구앞,문정동 근린공원,http://map.daum.net/?sName=송파역 2번 출구앞 대여소&eName=문정동 근린공원 대여소&target=bicycle
1251,1265,146,82,9579,9782,64,-203,1,0.280701754,석촌역 2번출구,문정동 근린공원,http://map.daum.net/?sName=석촌역 2번출구 대여소&eName=문정동 근린공원 대여소&target=bicycle
1201,1288,146,246,6406,7066,-100,-660,2,0.255102041,가락시장역 3번 출구,문정중교 사거리,http://map.daum.net/?sName=가락시장역 3번 출구 대여소&eName=문정중교 사거리 대여소&target=bicycle
1243,1288,181,345,9277,9808,-164,-531,3,0.311787072,문정 법조단지7,문정중교 사거리,http://map.daum.net/?sName=문정 법조단지7 대여소&eName=문정중교 사거리 대여소&target=bicycle
1265,1288,608,1116,6631,7053,-508,-422,10,0.294663573,문정동 근린공원,문정중교 사거리,http://map.daum.net/?sName=문정동 근린공원 대여소&eName=문정중교 사거리 대여소&target=bicycle
1227,1288,167,282,3523,3911,-115,-388,2,0.256124722,거여역 8번출구 뒤,문정중교 사거리,http://map.daum.net/?sName=거여역 8번출구 뒤 대여소&eName=문정중교 사거리 대여소&target=bicycle
1282,1288,96,151,3505,3900,-55,-395,1,0.222672065,송파소방서 맞은편(성내4교),문정중교 사거리,http://map.daum.net/?sName=송파소방서 맞은편(성내4교) 대여소&eName=문정중교 사거리 대여소&target=bicycle
1201,1211,270,161,6406,7066,109,-660,2,0.252900232,가락시장역 3번 출구,방이삼거리,http://map.daum.net/?sName=가락시장역 3번 출구 대여소&eName=방이삼거리 대여소&target=bicycle
1206,1211,138,74,8262,7754,64,508,1,0.301886792,9호선종합운동장역 9번출구,방이삼거리,http://map.daum.net/?sName=9호선종합운동장역 9번출구 대여소&eName=방이삼거리 대여소&target=bicycle
2122,2159,164,250,5117,4815,-86,302,1,0.207729469,낙성대로 입구,인헌초교,http://map.daum.net/?sName=낙성대로 입구 대여소&eName=인헌초교 대여소&target=bicycle
2128,2159,80,181,2415,2082,-101,333,2,0.38697318,관악구청교차로,인헌초교,http://map.daum.net/?sName=관악구청교차로 대여소&eName=인헌초교 대여소&target=bicycle
2129,2159,405,245,3395,2239,160,1156,3,0.246153846,낙성대 과학전시관,인헌초교,http://map.daum.net/?sName=낙성대 과학전시관 대여소&eName=인헌초교 대여소&target=bicycle
2148,2159,156,234,3634,3532,-78,102,1,0.2,낙성대역 3번출구 뒤,인헌초교,http://map.daum.net/?sName=낙성대역 3번출구 뒤 대여소&eName=인헌초교 대여소&target=bicycle
900,911,91,249,3252,3085,-158,167,3,0.464705882,은평예술회관,은평평화공원(역촌역4번출구),http://map.daum.net/?sName=은평예술회관 대여소&eName=은평평화공원(역촌역4번출구) 대여소&target=bicycle
901,911,111,274,4032,4189,-163,-157,3,0.423376623,응암1동사무소,은평평화공원(역촌역4번출구),http://map.daum.net/?sName=응암1동사무소 대여소&eName=은평평화공원(역촌역4번출구) 대여소&target=bicycle
805,811,60,158,4517,5252,-98,-735,1,0.449541284,문배어린이공원 앞,녹사평역1번출구,http://map.daum.net/?sName=문배어린이공원 앞 대여소&eName=녹사평역1번출구 대여소&target=bicycle
810,811,102,171,2877,2444,-69,433,1,0.252747253,이태원지하보도,녹사평역1번출구,http://map.daum.net/?sName=이태원지하보도 대여소&eName=녹사평역1번출구 대여소&target=bicycle
805,826,119,183,4517,5252,-64,-735,1,0.21192053,문배어린이공원 앞,서울역 서부교차로2,http://map.daum.net/?sName=문배어린이공원 앞 대여소&eName=서울역 서부교차로2 대여소&target=bicycle
180,826,149,67,3843,3072,82,771,1,0.37962963,충정로역 7번출구 뒤,서울역 서부교차로2,http://map.daum.net/?sName=충정로역 7번출구 뒤 대여소&eName=서울역 서부교차로2 대여소&target=bicycle
819,826,157,292,3868,4118,-135,-250,2,0.300668151,선린인터넷 고등학교,서울역 서부교차로2,http://map.daum.net/?sName=선린인터넷 고등학교 대여소&eName=서울역 서부교차로2 대여소&target=bicycle
146,185,158,426,10914,11574,-268,-660,5,0.45890411,마포역 1번출구 뒤,마포 신수공원 앞,http://map.daum.net/?sName=마포역 1번출구 뒤 대여소&eName=마포 신수공원 앞 대여소&target=bicycle
150,185,82,151,8165,7887,-69,278,1,0.296137339,서강대역 2번출구 앞,마포 신수공원 앞,http://map.daum.net/?sName=서강대역 2번출구 앞 대여소&eName=마포 신수공원 앞 대여소&target=bicycle
327,329,72,152,7393,6943,-80,450,1,0.357142857,낙원상가 옆,청계2가 사거리 옆,http://map.daum.net/?sName=낙원상가 옆 대여소&eName=청계2가 사거리 옆 대여소&target=bicycle
311,329,160,85,12978,9711,75,3267,1,0.306122449,서울광장 옆,청계2가 사거리 옆,http://map.daum.net/?sName=서울광장 옆 대여소&eName=청계2가 사거리 옆 대여소&target=bicycle
1334,1663,150,56,2038,1915,94,123,1,0.45631068,석관동주민센터 앞,동해문화예술관앞,http://map.daum.net/?sName=석관동주민센터 앞 대여소&eName=동해문화예술관앞 대여소&target=bicycle
1514,1531,64,170,5091,5039,-106,52,2,0.452991453,강북구청 사거리 버스정류소 앞,미아사거리 1번 출구,http://map.daum.net/?sName=강북구청 사거리 버스정류소 앞 대여소&eName=미아사거리 1번 출구 대여소&target=bicycle
1318,1531,268,156,4786,4831,112,-45,2,0.264150943,길음역 3번출구 뒤,미아사거리 1번 출구,http://map.daum.net/?sName=길음역 3번출구 뒤 대여소&eName=미아사거리 1번 출구 대여소&target=bicycle
1501,1531,397,607,4666,4733,-210,-67,4,0.209163347,"미아역 3번,4번 출구 사이",미아사거리 1번 출구,"http://map.daum.net/?sName=미아역 3번,4번 출구 사이 대여소&eName=미아사거리 1번 출구 대여소&target=bicycle"
1319,1531,314,208,5443,5718,106,-275,2,0.203065134,종암사거리 분수대,미아사거리 1번 출구,http://map.daum.net/?sName=종암사거리 분수대 대여소&eName=미아사거리 1번 출구 대여소&target=bicycle
1514,1530,155,59,5091,5039,96,52,1,0.448598131,강북구청 사거리 버스정류소 앞,광산사거리,http://map.daum.net/?sName=강북구청 사거리 버스정류소 앞 대여소&eName=광산사거리 대여소&target=bicycle
1506,1530,210,87,3313,3301,123,12,2,0.414141414,강북문화예술회관,광산사거리,http://map.daum.net/?sName=강북문화예술회관 대여소&eName=광산사거리 대여소&target=bicycle
1512,1530,148,227,4534,5099,-79,-565,1,0.210666667,강북중학교 앞,광산사거리,http://map.daum.net/?sName=강북중학교 앞 대여소&eName=광산사거리 대여소&target=bicycle
1514,1532,203,88,5091,5039,115,52,2,0.395189003,강북구청 사거리 버스정류소 앞,번3동 주민센터 교차로,http://map.daum.net/?sName=강북구청 사거리 버스정류소 앞 대여소&eName=번3동 주민센터 교차로 대여소&target=bicycle
119,121,65,172,7064,7554,-107,-490,2,0.451476793,서강나루 공원,마포소방서 앞,http://map.daum.net/?sName=서강나루 공원 대여소&eName=마포소방서 앞 대여소&target=bicycle
119,146,199,130,7064,7554,69,-490,1,0.209726444,서강나루 공원,마포역 1번출구 뒤,http://map.daum.net/?sName=서강나루 공원 대여소&eName=마포역 1번출구 뒤 대여소&target=bicycle
143,146,231,135,6109,6639,96,-530,1,0.262295082,공덕역 2번출구,마포역 1번출구 뒤,http://map.daum.net/?sName=공덕역 2번출구 대여소&eName=마포역 1번출구 뒤 대여소&target=bicycle
227,267,100,262,6651,8339,-162,-1688,3,0.447513812,양평2나들목 보행통로 입구,삼성화재 사옥 옆,http://map.daum.net/?sName=양평2나들목 보행통로 입구 대여소&eName=삼성화재 사옥 옆 대여소&target=bicycle
244,267,75,126,10470,11241,-51,-771,1,0.253731343,영등포삼환아파트 앞,삼성화재 사옥 옆,http://map.daum.net/?sName=영등포삼환아파트 앞 대여소&eName=삼성화재 사옥 옆 대여소&target=bicycle
227,268,122,241,6651,8339,-119,-1688,2,0.327823691,양평2나들목 보행통로 입구,그랜드컨벤션센터 앞,http://map.daum.net/?sName=양평2나들목 보행통로 입구 대여소&eName=그랜드컨벤션센터 앞 대여소&target=bicycle
229,268,151,283,6315,6641,-132,-326,2,0.304147465,양평1 보행육교 앞,그랜드컨벤션센터 앞,http://map.daum.net/?sName=양평1 보행육교 앞 대여소&eName=그랜드컨벤션센터 앞 대여소&target=bicycle
227,228,695,1067,6651,8339,-372,-1688,7,0.211123723,양평2나들목 보행통로 입구,선유도역 3번출구 앞,http://map.daum.net/?sName=양평2나들목 보행통로 입구 대여소&eName=선유도역 3번출구 앞 대여소&target=bicycle
1205,1221,465,178,6241,5434,287,807,5,0.446345257,종합운동장역 4번출구,삼전사거리 포스코더샵,http://map.daum.net/?sName=종합운동장역 4번출구 대여소&eName=삼전사거리 포스코더샵 대여소&target=bicycle
1205,1206,305,199,6241,5434,106,807,2,0.21031746,종합운동장역 4번출구,9호선종합운동장역 9번출구,http://map.daum.net/?sName=종합운동장역 4번출구 대여소&eName=9호선종합운동장역 9번출구 대여소&target=bicycle
1248,1267,349,134,8068,6857,215,1211,4,0.445134576,방이초등학교,올림픽공원 남2문 앞,http://map.daum.net/?sName=방이초등학교 대여소&eName=올림픽공원 남2문 앞 대여소&target=bicycle
1226,1267,128,208,6782,6927,-80,-145,1,0.238095238,잠실4동 주민센터 옆,올림픽공원 남2문 앞,http://map.daum.net/?sName=잠실4동 주민센터 옆 대여소&eName=올림픽공원 남2문 앞 대여소&target=bicycle
1248,1268,587,257,8068,6857,330,1211,6,0.390995261,방이초등학교,몽촌토성역 1번출구 옆,http://map.daum.net/?sName=방이초등학교 대여소&eName=몽촌토성역 1번출구 옆 대여소&target=bicycle
1022,1268,67,154,4865,4825,-87,40,1,0.393665158,길동 사거리(초소앞),몽촌토성역 1번출구 옆,http://map.daum.net/?sName=길동 사거리(초소앞) 대여소&eName=몽촌토성역 1번출구 옆 대여소&target=bicycle
1029,1268,114,184,6247,6417,-70,-170,1,0.234899329,롯데 시네마,몽촌토성역 1번출구 옆,http://map.daum.net/?sName=롯데 시네마 대여소&eName=몽촌토성역 1번출구 옆 대여소&target=bicycle
1011,1268,121,224,10393,10422,-103,-29,2,0.298550725,LIGA 아파트 앞,몽촌토성역 1번출구 옆,http://map.daum.net/?sName=LIGA 아파트 앞 대여소&eName=몽촌토성역 1번출구 옆 대여소&target=bicycle
1824,1835,177,68,4038,4162,109,-124,2,0.444897959,독산근린공원 입구,STX V타워,http://map.daum.net/?sName=독산근린공원 입구 대여소&eName=STX V타워 대여소&target=bicycle
1405,1425,60,156,6638,7199,-96,-561,1,0.444444444,망우역 1번출구,용마문화복지센터,http://map.daum.net/?sName=망우역 1번출구 대여소&eName=용마문화복지센터 대여소&target=bicycle
1405,1430,155,350,6638,7199,-195,-561,3,0.386138614,망우역 1번출구,중랑구청,http://map.daum.net/?sName=망우역 1번출구 대여소&eName=중랑구청 대여소&target=bicycle
1403,1430,60,141,9199,9529,-81,-330,1,0.402985075,중화빌딩 앞 (동부시장),중랑구청,http://map.daum.net/?sName=중화빌딩 앞 (동부시장) 대여소&eName=중랑구청 대여소&target=bicycle
1413,1430,96,146,3021,3626,-50,-605,1,0.20661157,봉화산역 5번출구 뒤,중랑구청,http://map.daum.net/?sName=봉화산역 5번출구 뒤 대여소&eName=중랑구청 대여소&target=bicycle
1405,1454,91,142,6638,7199,-51,-561,1,0.21888412,망우역 1번출구,한국전력공사(동대문 중랑지사),http://map.daum.net/?sName=망우역 1번출구 대여소&eName=한국전력공사(동대문 중랑지사) 대여소&target=bicycle
1403,1454,161,86,9199,9529,75,-330,1,0.303643725,중화빌딩 앞 (동부시장),한국전력공사(동대문 중랑지사),http://map.daum.net/?sName=중화빌딩 앞 (동부시장) 대여소&eName=한국전력공사(동대문 중랑지사) 대여소&target=bicycle
2119,2148,112,291,4150,3982,-179,168,3,0.444168734,중앙동 동진빌딩,낙성대역 3번출구 뒤,http://map.daum.net/?sName=중앙동 동진빌딩 대여소&eName=낙성대역 3번출구 뒤 대여소&target=bicycle
2129,2148,642,323,3395,2239,319,1156,6,0.330569948,낙성대 과학전시관,낙성대역 3번출구 뒤,http://map.daum.net/?sName=낙성대 과학전시관 대여소&eName=낙성대역 3번출구 뒤 대여소&target=bicycle
2119,2167,67,136,4150,3982,-69,168,1,0.339901478,중앙동 동진빌딩,낙성대역 1번출구,http://map.daum.net/?sName=중앙동 동진빌딩 대여소&eName=낙성대역 1번출구 대여소&target=bicycle
1118,742,142,368,8828,10711,-226,-1883,4,0.443137255,증미역 3번출구뒤(등촌두산위브센티움오피스텔),등촌역 5번 출구 뒤,http://map.daum.net/?sName=증미역 3번출구뒤(등촌두산위브센티움오피스텔) 대여소&eName=등촌역 5번 출구 뒤 대여소&target=bicycle
1119,742,76,145,5026,5912,-69,-886,1,0.312217195,염창동 한마음아파트앞(염창동 빛나는 음악학원앞),등촌역 5번 출구 뒤,http://map.daum.net/?sName=염창동 한마음아파트앞(염창동 빛나는 음악학원앞) 대여소&eName=등촌역 5번 출구 뒤 대여소&target=bicycle
1118,1131,202,109,8828,10711,93,-1883,1,0.29903537,증미역 3번출구뒤(등촌두산위브센티움오피스텔),꿈돌이공원 앞,http://map.daum.net/?sName=증미역 3번출구뒤(등촌두산위브센티움오피스텔) 대여소&eName=꿈돌이공원 앞 대여소&target=bicycle
1128,1131,187,113,2844,2517,74,327,1,0.246666667,화곡역 6번출구,꿈돌이공원 앞,http://map.daum.net/?sName=화곡역 6번출구 대여소&eName=꿈돌이공원 앞 대여소&target=bicycle
1118,700,234,394,8828,10711,-160,-1883,3,0.25477707,증미역 3번출구뒤(등촌두산위브센티움오피스텔),KB국민은행 염창역 지점 앞,http://map.daum.net/?sName=증미역 3번출구뒤(등촌두산위브센티움오피스텔) 대여소&eName=KB국민은행 염창역 지점 앞 대여소&target=bicycle
1135,700,144,268,3790,3474,-124,316,2,0.300970874,강서구의회,KB국민은행 염창역 지점 앞,http://map.daum.net/?sName=강서구의회 대여소&eName=KB국민은행 염창역 지점 앞 대여소&target=bicycle
272,700,192,105,15336,16147,87,-811,1,0.292929293,당산육갑문,KB국민은행 염창역 지점 앞,http://map.daum.net/?sName=당산육갑문 대여소&eName=KB국민은행 염창역 지점 앞 대여소&target=bicycle
1118,1124,118,195,8828,10711,-77,-1883,1,0.24600639,증미역 3번출구뒤(등촌두산위브센티움오피스텔),발산역 6번출구옆(다이소앞),http://map.daum.net/?sName=증미역 3번출구뒤(등촌두산위브센티움오피스텔) 대여소&eName=발산역 6번출구옆(다이소앞) 대여소&target=bicycle
1112,1124,178,274,10148,10803,-96,-655,1,0.212389381,마곡엠밸리4단지 정문,발산역 6번출구옆(다이소앞),http://map.daum.net/?sName=마곡엠밸리4단지 정문 대여소&eName=발산역 6번출구옆(다이소앞) 대여소&target=bicycle
3507,3516,128,74,4854,3027,54,1827,1,0.267326733,어린이회관,구의아리수정수센터앞,http://map.daum.net/?sName=어린이회관 대여소&eName=구의아리수정수센터앞 대여소&target=bicycle
3507,540,135,81,4854,3027,54,1827,1,0.25,어린이회관,군자역 7번출구 베스트샵 앞,http://map.daum.net/?sName=어린이회관 대여소&eName=군자역 7번출구 베스트샵 앞 대여소&target=bicycle
500,540,731,350,13978,12760,381,1218,7,0.352451434,어린이대공원역 3번출구 앞,군자역 7번출구 베스트샵 앞,http://map.daum.net/?sName=어린이대공원역 3번출구 앞 대여소&eName=군자역 7번출구 베스트샵 앞 대여소&target=bicycle
514,540,161,276,11672,12181,-115,-509,2,0.263157895,성수사거리 버스정류장 앞,군자역 7번출구 베스트샵 앞,http://map.daum.net/?sName=성수사거리 버스정류장 앞 대여소&eName=군자역 7번출구 베스트샵 앞 대여소&target=bicycle
3507,3520,154,98,4854,3027,56,1827,1,0.222222222,어린이회관,광진경찰서,http://map.daum.net/?sName=어린이회관 대여소&eName=광진경찰서 대여소&target=bicycle
3504,3520,254,110,6893,6202,144,691,2,0.395604396,원일교회,광진경찰서,http://map.daum.net/?sName=원일교회 대여소&eName=광진경찰서 대여소&target=bicycle
1209,1235,72,185,14401,14405,-113,-4,2,0.439688716,잠실나루역 (2번 출구 쪽),잠실트리지움310동 옆,http://map.daum.net/?sName=잠실나루역 (2번 출구 쪽) 대여소&eName=잠실트리지움310동 옆 대여소&target=bicycle
1220,1235,196,120,6741,7523,76,-782,1,0.240506329,잠실본동주민센터뒤 잠실근린공원,잠실트리지움310동 옆,http://map.daum.net/?sName=잠실본동주민센터뒤 잠실근린공원 대여소&eName=잠실트리지움310동 옆 대여소&target=bicycle
1212,1235,79,130,6783,7281,-51,-498,1,0.244019139,송파역 2번 출구앞,잠실트리지움310동 옆,http://map.daum.net/?sName=송파역 2번 출구앞 대여소&eName=잠실트리지움310동 옆 대여소&target=bicycle
1209,1289,410,180,14401,14405,230,-4,4,0.389830508,잠실나루역 (2번 출구 쪽),풍납동 자전거보관소,http://map.daum.net/?sName=잠실나루역 (2번 출구 쪽) 대여소&eName=풍납동 자전거보관소 대여소&target=bicycle
1029,1289,170,75,6247,6417,95,-170,1,0.387755102,롯데 시네마,풍납동 자전거보관소,http://map.daum.net/?sName=롯데 시네마 대여소&eName=풍납동 자전거보관소 대여소&target=bicycle
1208,1289,454,210,6864,7353,244,-489,4,0.36746988,풍납현대아파트쉼터,풍납동 자전거보관소,http://map.daum.net/?sName=풍납현대아파트쉼터 대여소&eName=풍납동 자전거보관소 대여소&target=bicycle
1009,1289,296,147,12114,11462,149,652,2,0.336343115,천호역4번출구(현대백화점),풍납동 자전거보관소,http://map.daum.net/?sName=천호역4번출구(현대백화점) 대여소&eName=풍납동 자전거보관소 대여소&target=bicycle
546,592,70,134,6752,7127,-64,-375,1,0.31372549,잠실대교북단 교차로,건국대학교 학생회관,http://map.daum.net/?sName=잠실대교북단 교차로 대여소&eName=건국대학교 학생회관 대여소&target=bicycle
584,592,206,114,11250,8295,92,2955,1,0.2875,광진광장 교통섬,건국대학교 학생회관,http://map.daum.net/?sName=광진광장 교통섬 대여소&eName=건국대학교 학생회관 대여소&target=bicycle
3513,518,195,76,7483,4882,119,2601,2,0.439114391,상왕십리역 1번출구,청계천 박물관 앞,http://map.daum.net/?sName=상왕십리역 1번출구 대여소&eName=청계천 박물관 앞 대여소&target=bicycle
378,518,141,69,7304,7234,72,70,1,0.342857143,청계7가 사거리,청계천 박물관 앞,http://map.daum.net/?sName=청계7가 사거리 대여소&eName=청계천 박물관 앞 대여소&target=bicycle
3513,530,298,131,7483,4882,167,2601,3,0.389277389,상왕십리역 1번출구,청계벽산아파트 앞,http://map.daum.net/?sName=상왕십리역 1번출구 대여소&eName=청계벽산아파트 앞 대여소&target=bicycle
518,530,62,143,3645,3560,-81,85,1,0.395121951,청계천 박물관 앞,청계벽산아파트 앞,http://map.daum.net/?sName=청계천 박물관 앞 대여소&eName=청계벽산아파트 앞 대여소&target=bicycle
3513,557,543,260,7483,4882,283,2601,5,0.352428394,상왕십리역 1번출구,도선동 주민센터 앞,http://map.daum.net/?sName=상왕십리역 1번출구 대여소&eName=도선동 주민센터 앞 대여소&target=bicycle
530,557,89,165,4597,5182,-76,-585,1,0.299212598,청계벽산아파트 앞,도선동 주민센터 앞,http://map.daum.net/?sName=청계벽산아파트 앞 대여소&eName=도선동 주민센터 앞 대여소&target=bicycle
1303,386,201,119,5357,5252,82,105,1,0.25625,돈암초교 입구,올림픽기념 국민생활관 앞,http://map.daum.net/?sName=돈암초교 입구 대여소&eName=올림픽기념 국민생활관 앞 대여소&target=bicycle
2328,2349,67,170,2859,2382,-103,477,2,0.434599156,르네상스 호텔 사거리 역삼지하보도 7번출구 앞,역삼빌딩 앞(하나은행 옆),http://map.daum.net/?sName=르네상스 호텔 사거리 역삼지하보도 7번출구 앞 대여소&eName=역삼빌딩 앞(하나은행 옆) 대여소&target=bicycle
2328,2332,147,66,2859,2382,81,477,1,0.38028169,르네상스 호텔 사거리 역삼지하보도 7번출구 앞,선릉역3번출구,http://map.daum.net/?sName=르네상스 호텔 사거리 역삼지하보도 7번출구 앞 대여소&eName=선릉역3번출구 대여소&target=bicycle
184,199,147,58,7878,7950,89,-72,1,0.434146341,SK망원동주유소 건너편,서울 월드컵 경기장,http://map.daum.net/?sName=SK망원동주유소 건너편 대여소&eName=서울 월드컵 경기장 대여소&target=bicycle
186,199,92,219,9655,10165,-127,-510,2,0.408360129,월드컵공원,서울 월드컵 경기장,http://map.daum.net/?sName=월드컵공원 대여소&eName=서울 월드컵 경기장 대여소&target=bicycle
1124,1126,363,919,6953,6940,-556,13,11,0.433697348,발산역 6번출구옆(다이소앞),우장산역 1번출구옆(우장산아이파크105동앞),http://map.daum.net/?sName=발산역 6번출구옆(다이소앞) 대여소&eName=우장산역 1번출구옆(우장산아이파크105동앞) 대여소&target=bicycle
1125,1126,197,323,4934,4759,-126,175,2,0.242307692,명덕고교입구(영종빌딩),우장산역 1번출구옆(우장산아이파크105동앞),http://map.daum.net/?sName=명덕고교입구(영종빌딩) 대여소&eName=우장산역 1번출구옆(우장산아이파크105동앞) 대여소&target=bicycle
1124,1148,74,181,6953,6940,-107,13,2,0.419607843,발산역 6번출구옆(다이소앞),볏골공원,http://map.daum.net/?sName=발산역 6번출구옆(다이소앞) 대여소&eName=볏골공원 대여소&target=bicycle
1124,1132,168,89,6953,6940,79,13,1,0.307392996,발산역 6번출구옆(다이소앞),등촌역 7번출구,http://map.daum.net/?sName=발산역 6번출구옆(다이소앞) 대여소&eName=등촌역 7번출구 대여소&target=bicycle
1124,1160,478,267,6953,6940,211,13,4,0.283221477,발산역 6번출구옆(다이소앞),양천향교역 7번출구앞,http://map.daum.net/?sName=발산역 6번출구옆(다이소앞) 대여소&eName=양천향교역 7번출구앞 대여소&target=bicycle
1124,1158,208,137,6953,6940,71,13,1,0.205797101,발산역 6번출구옆(다이소앞),가양역 8번출구,http://map.daum.net/?sName=발산역 6번출구옆(다이소앞) 대여소&eName=가양역 8번출구 대여소&target=bicycle
1157,1158,277,497,4647,5897,-220,-1250,4,0.284237726,강서구청,가양역 8번출구,http://map.daum.net/?sName=강서구청 대여소&eName=가양역 8번출구 대여소&target=bicycle
314,334,154,77,7832,7432,77,400,1,0.333333333,국립현대미술관,종로3가역 2번출구 뒤,http://map.daum.net/?sName=국립현대미술관 대여소&eName=종로3가역 2번출구 뒤 대여소&target=bicycle
314,450,91,173,7832,7432,-82,400,1,0.310606061,국립현대미술관,효자동 삼거리,http://map.daum.net/?sName=국립현대미술관 대여소&eName=효자동 삼거리 대여소&target=bicycle
117,161,87,177,10247,10327,-90,-80,1,0.340909091,홍은사거리,무악재역1번 출구,http://map.daum.net/?sName=홍은사거리 대여소&eName=무악재역1번 출구 대여소&target=bicycle
117,123,322,513,10247,10327,-191,-80,3,0.228742515,홍은사거리,문화촌 공원,http://map.daum.net/?sName=홍은사거리 대여소&eName=문화촌 공원 대여소&target=bicycle
1211,1231,140,349,15893,16495,-209,-602,4,0.427402863,방이삼거리,잠실역 6번출구,http://map.daum.net/?sName=방이삼거리 대여소&eName=잠실역 6번출구 대여소&target=bicycle
1220,1231,79,129,6741,7523,-50,-782,1,0.240384615,잠실본동주민센터뒤 잠실근린공원,잠실역 6번출구,http://map.daum.net/?sName=잠실본동주민센터뒤 잠실근린공원 대여소&eName=잠실역 6번출구 대여소&target=bicycle
1221,1231,131,244,8629,11466,-113,-2837,2,0.301333333,삼전사거리 포스코더샵,잠실역 6번출구,http://map.daum.net/?sName=삼전사거리 포스코더샵 대여소&eName=잠실역 6번출구 대여소&target=bicycle
1224,1231,288,504,7704,7777,-216,-73,4,0.272727273,아시아지하보도 2번 출구,잠실역 6번출구,http://map.daum.net/?sName=아시아지하보도 2번 출구 대여소&eName=잠실역 6번출구 대여소&target=bicycle
1211,1269,101,158,15893,16495,-57,-602,1,0.22007722,방이삼거리,리센츠아파트,http://map.daum.net/?sName=방이삼거리 대여소&eName=리센츠아파트 대여소&target=bicycle
378,550,172,69,7304,7234,103,70,2,0.427385892,청계7가 사거리,서울시설공단 앞,http://map.daum.net/?sName=청계7가 사거리 대여소&eName=서울시설공단 앞 대여소&target=bicycle
378,605,105,221,7304,7234,-116,70,2,0.355828221,청계7가 사거리,신설동역8번출구,http://map.daum.net/?sName=청계7가 사거리 대여소&eName=신설동역8번출구 대여소&target=bicycle
2369,2380,100,249,4645,3619,-149,1026,2,0.426934097,KT선릉타워,삼성동베이직하우스앞,http://map.daum.net/?sName=KT선릉타워 대여소&eName=삼성동베이직하우스앞 대여소&target=bicycle
2348,2380,95,176,5698,5969,-81,-271,1,0.298892989,포스코사거리(기업은행),삼성동베이직하우스앞,http://map.daum.net/?sName=포스코사거리(기업은행) 대여소&eName=삼성동베이직하우스앞 대여소&target=bicycle
2315,2380,74,138,5723,5593,-64,130,1,0.301886792,봉은사역 5번출구 옆,삼성동베이직하우스앞,http://map.daum.net/?sName=봉은사역 5번출구 옆 대여소&eName=삼성동베이직하우스앞 대여소&target=bicycle
639,650,236,95,7181,5647,141,1534,2,0.425981873,서울시립대 후문,중랑교사거리,http://map.daum.net/?sName=서울시립대 후문 대여소&eName=중랑교사거리 대여소&target=bicycle
606,650,84,187,2422,3129,-103,-707,2,0.380073801,휘경공고앞,중랑교사거리,http://map.daum.net/?sName=휘경공고앞 대여소&eName=중랑교사거리 대여소&target=bicycle
1253,1275,149,60,2855,2453,89,402,1,0.425837321,오금역 3번 출구 뒤,거여초등학교 옆,http://map.daum.net/?sName=오금역 3번 출구 뒤 대여소&eName=거여초등학교 옆 대여소&target=bicycle
828,834,206,83,4063,4119,123,-56,2,0.425605536,숙대입구역 8번,효창공원앞역 3번출구 뒤,http://map.daum.net/?sName=숙대입구역 8번 대여소&eName=효창공원앞역 3번출구 뒤 대여소&target=bicycle
3519,648,83,205,6209,7562,-122,-1353,2,0.423611111,용답역 1번 출구,장안동위더스빌옆,http://map.daum.net/?sName=용답역 1번 출구 대여소&eName=장안동위더스빌옆 대여소&target=bicycle
3519,526,145,274,6209,7562,-129,-1353,2,0.307875895,용답역 1번 출구,용답토속공원 앞,http://map.daum.net/?sName=용답역 1번 출구 대여소&eName=용답토속공원 앞 대여소&target=bicycle
3519,525,90,143,6209,7562,-53,-1353,1,0.227467811,용답역 1번 출구,한양대병원사거리,http://map.daum.net/?sName=용답역 1번 출구 대여소&eName=한양대병원사거리 대여소&target=bicycle
3514,525,121,183,6762,6297,-62,465,1,0.203947368,왕십리교회옆,한양대병원사거리,http://map.daum.net/?sName=왕십리교회옆 대여소&eName=한양대병원사거리 대여소&target=bicycle
901,912,171,100,4032,4189,71,-157,1,0.26199262,응암1동사무소,응암오거리,http://map.daum.net/?sName=응암1동사무소 대여소&eName=응암오거리 대여소&target=bicycle
409,912,126,192,11080,13610,-66,-2530,1,0.20754717,누리꿈스퀘어 옆,응암오거리,http://map.daum.net/?sName=누리꿈스퀘어 옆 대여소&eName=응암오거리 대여소&target=bicycle
906,912,214,120,9121,9759,94,-638,1,0.281437126,연신내역 5번출구150M 아래,응암오거리,http://map.daum.net/?sName=연신내역 5번출구150M 아래 대여소&eName=응암오거리 대여소&target=bicycle
418,912,222,134,11442,11253,88,189,1,0.247191011,월드컵경기장역 3번출구 옆,응암오거리,http://map.daum.net/?sName=월드컵경기장역 3번출구 옆 대여소&eName=응암오거리 대여소&target=bicycle
1438,1441,403,993,4913,6433,-590,-1520,11,0.422636103,홈플러스 신내점 앞,신내능말공원,http://map.daum.net/?sName=홈플러스 신내점 앞 대여소&eName=신내능말공원 대여소&target=bicycle
202,203,446,1010,13050,14170,-564,-1120,11,0.387362637,국민일보 앞,국회의사당역 3번출구 옆,http://map.daum.net/?sName=국민일보 앞 대여소&eName=국회의사당역 3번출구 옆 대여소&target=bicycle
201,203,201,351,7801,7985,-150,-184,3,0.27173913,진미파라곤 앞,국회의사당역 3번출구 옆,http://map.daum.net/?sName=진미파라곤 앞 대여소&eName=국회의사당역 3번출구 옆 대여소&target=bicycle
1531,1709,169,69,8214,8990,100,-776,2,0.420168067,미아사거리 1번 출구,쌍문역4번출구 주변,http://map.daum.net/?sName=미아사거리 1번 출구 대여소&eName=쌍문역4번출구 주변 대여소&target=bicycle
1512,1709,79,139,4534,5099,-60,-565,1,0.275229358,강북중학교 앞,쌍문역4번출구 주변,http://map.daum.net/?sName=강북중학교 앞 대여소&eName=쌍문역4번출구 주변 대여소&target=bicycle
1706,1709,246,469,4312,5011,-223,-699,4,0.311888112,기업은행 앞,쌍문역4번출구 주변,http://map.daum.net/?sName=기업은행 앞 대여소&eName=쌍문역4번출구 주변 대여소&target=bicycle
1530,1709,88,148,4520,4644,-60,-124,1,0.254237288,광산사거리,쌍문역4번출구 주변,http://map.daum.net/?sName=광산사거리 대여소&eName=쌍문역4번출구 주변 대여소&target=bicycle
1531,1534,98,150,8214,8990,-52,-776,1,0.209677419,미아사거리 1번 출구,북서울 꿈의 숲 동문,http://map.daum.net/?sName=미아사거리 1번 출구 대여소&eName=북서울 꿈의 숲 동문 대여소&target=bicycle
102,115,96,182,14864,13529,-86,1335,1,0.309352518,망원역 1번출구 앞,사루비아 빌딩 앞,http://map.daum.net/?sName=망원역 1번출구 앞 대여소&eName=사루비아 빌딩 앞 대여소&target=bicycle
107,115,70,148,12206,14037,-78,-1831,1,0.357798165,신한은행 서교동금융센터점 앞,사루비아 빌딩 앞,http://map.daum.net/?sName=신한은행 서교동금융센터점 앞 대여소&eName=사루비아 빌딩 앞 대여소&target=bicycle
104,115,124,196,8938,8510,-72,428,1,0.225,합정역 1번출구 앞,사루비아 빌딩 앞,http://map.daum.net/?sName=합정역 1번출구 앞 대여소&eName=사루비아 빌딩 앞 대여소&target=bicycle
102,106,311,535,14864,13529,-224,1335,4,0.264775414,망원역 1번출구 앞,합정역 7번출구 앞,http://map.daum.net/?sName=망원역 1번출구 앞 대여소&eName=합정역 7번출구 앞 대여소&target=bicycle
104,106,202,103,8938,8510,99,428,1,0.324590164,합정역 1번출구 앞,합정역 7번출구 앞,http://map.daum.net/?sName=합정역 1번출구 앞 대여소&eName=합정역 7번출구 앞 대여소&target=bicycle
102,109,320,205,14864,13529,115,1335,2,0.219047619,망원역 1번출구 앞,제일빌딩 앞,http://map.daum.net/?sName=망원역 1번출구 앞 대여소&eName=제일빌딩 앞 대여소&target=bicycle
105,109,331,213,5689,4736,118,953,2,0.216911765,합정역 5번출구 앞,제일빌딩 앞,http://map.daum.net/?sName=합정역 5번출구 앞 대여소&eName=제일빌딩 앞 대여소&target=bicycle
103,109,319,197,10248,9142,122,1106,2,0.236434109,망원역 2번출구 앞,제일빌딩 앞,http://map.daum.net/?sName=망원역 2번출구 앞 대여소&eName=제일빌딩 앞 대여소&target=bicycle
101,109,200,105,3994,4062,95,-68,1,0.31147541,(구)합정동 주민센터,제일빌딩 앞,http://map.daum.net/?sName=(구)합정동 주민센터 대여소&eName=제일빌딩 앞 대여소&target=bicycle
102,107,1358,872,14864,13529,486,1335,9,0.21793722,망원역 1번출구 앞,신한은행 서교동금융센터점 앞,http://map.daum.net/?sName=망원역 1번출구 앞 대여소&eName=신한은행 서교동금융센터점 앞 대여소&target=bicycle
102,105,118,180,14864,13529,-62,1335,1,0.208053691,망원역 1번출구 앞,합정역 5번출구 앞,http://map.daum.net/?sName=망원역 1번출구 앞 대여소&eName=합정역 5번출구 앞 대여소&target=bicycle
2348,2388,99,241,5698,5969,-142,-271,2,0.417647059,포스코사거리(기업은행),강남구 도시관리공단,http://map.daum.net/?sName=포스코사거리(기업은행) 대여소&eName=강남구 도시관리공단 대여소&target=bicycle
1204,1207,221,91,3375,3421,130,-46,2,0.416666667,거여역 3번출구,마천CU우방점 앞,http://map.daum.net/?sName=거여역 3번출구 대여소&eName=마천CU우방점 앞 대여소&target=bicycle
1506,1540,128,246,3313,3301,-118,12,2,0.315508021,강북문화예술회관,가오리역,http://map.daum.net/?sName=강북문화예술회관 대여소&eName=가오리역 대여소&target=bicycle
1512,1540,219,136,4534,5099,83,-565,1,0.233802817,강북중학교 앞,가오리역,http://map.daum.net/?sName=강북중학교 앞 대여소&eName=가오리역 대여소&target=bicycle
1539,1540,159,240,3734,4266,-81,-532,1,0.203007519,4.19민주묘지역,가오리역,http://map.daum.net/?sName=4.19민주묘지역 대여소&eName=가오리역 대여소&target=bicycle
417,419,177,113,8832,6175,64,2657,1,0.220689655,DMC역 2번출구 옆,홈플러스 앞,http://map.daum.net/?sName=DMC역 2번출구 옆 대여소&eName=홈플러스 앞 대여소&target=bicycle
194,419,132,226,8218,8418,-94,-200,1,0.262569832,증산교 앞,홈플러스 앞,http://map.daum.net/?sName=증산교 앞 대여소&eName=홈플러스 앞 대여소&target=bicycle
192,419,137,86,3757,3993,51,-236,1,0.228699552,연서어린이공원,홈플러스 앞,http://map.daum.net/?sName=연서어린이공원 대여소&eName=홈플러스 앞 대여소&target=bicycle
1709,1723,328,137,7817,7156,191,661,3,0.410752688,쌍문역4번출구 주변,방학동학마을도서관,http://map.daum.net/?sName=쌍문역4번출구 주변 대여소&eName=방학동학마을도서관 대여소&target=bicycle
1709,1713,172,101,7817,7156,71,661,1,0.26007326,쌍문역4번출구 주변,쌍문동 청소년 랜드,http://map.daum.net/?sName=쌍문역4번출구 주변 대여소&eName=쌍문동 청소년 랜드 대여소&target=bicycle
1535,1713,351,195,7030,7051,156,-21,3,0.285714286,효성인텔리안 앞,쌍문동 청소년 랜드,http://map.daum.net/?sName=효성인텔리안 앞 대여소&eName=쌍문동 청소년 랜드 대여소&target=bicycle
1526,1713,131,78,2139,1988,53,151,1,0.253588517,수유동 채선당앞,쌍문동 청소년 랜드,http://map.daum.net/?sName=수유동 채선당앞 대여소&eName=쌍문동 청소년 랜드 대여소&target=bicycle
1709,1722,149,92,7817,7156,57,661,1,0.236514523,쌍문역4번출구 주변,창동청소년수련관,http://map.daum.net/?sName=쌍문역4번출구 주변 대여소&eName=창동청소년수련관 대여소&target=bicycle
1827,1834,66,158,5801,6111,-92,-310,1,0.410714286,독산보도육교 앞 자전거 보관소,월드메르디앙 벤처센터 2차,http://map.daum.net/?sName=독산보도육교 앞 자전거 보관소 대여소&eName=월드메르디앙 벤처센터 2차 대여소&target=bicycle
2206,2270,93,183,4671,4677,-90,-6,1,0.326086957,언남초등학교 앞,서초포레스타 7단지,http://map.daum.net/?sName=언남초등학교 앞 대여소&eName=서초포레스타 7단지 대여소&target=bicycle
2206,2256,150,91,4671,4677,59,-6,1,0.244813278,언남초등학교 앞,양재동 꽃시장 입구,http://map.daum.net/?sName=언남초등학교 앞 대여소&eName=양재동 꽃시장 입구 대여소&target=bicycle
2247,2256,218,127,4646,4933,91,-287,1,0.263768116,섬들근린공원,양재동 꽃시장 입구,http://map.daum.net/?sName=섬들근린공원 대여소&eName=양재동 꽃시장 입구 대여소&target=bicycle
2128,2169,135,66,2415,2082,69,333,1,0.343283582,관악구청교차로,봉천역 2번출구,http://map.daum.net/?sName=관악구청교차로 대여소&eName=봉천역 2번출구 대여소&target=bicycle
263,264,108,257,7915,7976,-149,-61,2,0.408219178,근로자회관 사거리,교보생명보험 앞,http://map.daum.net/?sName=근로자회관 사거리 대여소&eName=교보생명보험 앞 대여소&target=bicycle
1126,1167,271,114,5078,4581,157,497,3,0.407792208,우장산역 1번출구옆(우장산아이파크105동앞),마곡수명산파크3단지 교차로,http://map.daum.net/?sName=우장산역 1번출구옆(우장산아이파크105동앞) 대여소&eName=마곡수명산파크3단지 교차로 대여소&target=bicycle
1125,1167,239,143,4934,4759,96,175,1,0.251308901,명덕고교입구(영종빌딩),마곡수명산파크3단지 교차로,http://map.daum.net/?sName=명덕고교입구(영종빌딩) 대여소&eName=마곡수명산파크3단지 교차로 대여소&target=bicycle
1160,1167,210,138,11546,11615,72,-69,1,0.206896552,양천향교역 7번출구앞,마곡수명산파크3단지 교차로,http://map.daum.net/?sName=양천향교역 7번출구앞 대여소&eName=마곡수명산파크3단지 교차로 대여소&target=bicycle
1126,1166,185,104,5078,4581,81,497,1,0.280276817,우장산역 1번출구옆(우장산아이파크105동앞),강서구립등빛도서관,http://map.daum.net/?sName=우장산역 1번출구옆(우장산아이파크105동앞) 대여소&eName=강서구립등빛도서관 대여소&target=bicycle
1111,1166,150,96,3128,2865,54,263,1,0.219512195,마곡엠밸리6_7단지 마곡중학교,강서구립등빛도서관,http://map.daum.net/?sName=마곡엠밸리6_7단지 마곡중학교 대여소&eName=강서구립등빛도서관 대여소&target=bicycle
1126,1127,104,171,5078,4581,-67,497,1,0.243636364,우장산역 1번출구옆(우장산아이파크105동앞),화곡역(에이스정형외과앞) 버스정류장,http://map.daum.net/?sName=우장산역 1번출구옆(우장산아이파크105동앞) 대여소&eName=화곡역(에이스정형외과앞) 버스정류장 대여소&target=bicycle
2341,2376,177,75,2059,1775,102,284,2,0.404761905,일원역 4~5번 출구 사이,수서역 6번출구 앞,http://map.daum.net/?sName=일원역 4~5번 출구 사이 대여소&eName=수서역 6번출구 앞 대여소&target=bicycle
1403,1455,91,193,9199,9529,-102,-330,2,0.35915493,중화빌딩 앞 (동부시장),상봉역 2번 출구,http://map.daum.net/?sName=중화빌딩 앞 (동부시장) 대여소&eName=상봉역 2번 출구 대여소&target=bicycle
1446,1455,121,208,4425,5090,-87,-665,1,0.26443769,중랑전화국 교차로,상봉역 2번 출구,http://map.daum.net/?sName=중랑전화국 교차로 대여소&eName=상봉역 2번 출구 대여소&target=bicycle
1403,1451,255,155,9199,9529,100,-330,2,0.243902439,중화빌딩 앞 (동부시장),중랑세무서,http://map.daum.net/?sName=중화빌딩 앞 (동부시장) 대여소&eName=중랑세무서 대여소&target=bicycle
908,931,204,87,3404,3394,117,10,2,0.402061856,구산역 4번출구,역촌파출소,http://map.daum.net/?sName=구산역 4번출구 대여소&eName=역촌파출소 대여소&target=bicycle
926,931,267,176,6546,6833,91,-287,1,0.205417607,불광역 8번출구,역촌파출소,http://map.daum.net/?sName=불광역 8번출구 대여소&eName=역촌파출소 대여소&target=bicycle
908,913,80,149,3404,3394,-69,10,1,0.301310044,구산역 4번출구,이마트 은평점,http://map.daum.net/?sName=구산역 4번출구 대여소&eName=이마트 은평점 대여소&target=bicycle
419,913,191,119,13162,11585,72,1577,1,0.232258065,홈플러스 앞,이마트 은평점,http://map.daum.net/?sName=홈플러스 앞 대여소&eName=이마트 은평점 대여소&target=bicycle
238,240,143,61,8430,8601,82,-171,1,0.401960784,제2구민체육센타 앞,문래역 4번출구 앞,http://map.daum.net/?sName=제2구민체육센타 앞 대여소&eName=문래역 4번출구 앞 대여소&target=bicycle
239,240,95,164,6606,6223,-69,383,1,0.266409266,유스호스텔 앞,문래역 4번출구 앞,http://map.daum.net/?sName=유스호스텔 앞 대여소&eName=문래역 4번출구 앞 대여소&target=bicycle
124,132,208,89,7757,6792,119,965,2,0.400673401,서강대 정문 건너편,창천문화공원,http://map.daum.net/?sName=서강대 정문 건너편 대여소&eName=창천문화공원 대여소&target=bicycle
111,132,129,75,8788,8233,54,555,1,0.264705882,상수역 2번출구 앞,창천문화공원,http://map.daum.net/?sName=상수역 2번출구 앞 대여소&eName=창천문화공원 대여소&target=bicycle
811,816,675,290,4447,2321,385,2126,7,0.398963731,녹사평역1번출구,신용산역 6번출구 앞,http://map.daum.net/?sName=녹사평역1번출구 대여소&eName=신용산역 6번출구 앞 대여소&target=bicycle
810,816,325,213,2877,2444,112,433,2,0.208178439,이태원지하보도,신용산역 6번출구 앞,http://map.daum.net/?sName=이태원지하보도 대여소&eName=신용산역 6번출구 앞 대여소&target=bicycle
812,816,222,127,2600,2209,95,391,1,0.272206304,용산전쟁기념관,신용산역 6번출구 앞,http://map.daum.net/?sName=용산전쟁기념관 대여소&eName=신용산역 6번출구 앞 대여소&target=bicycle
811,812,310,173,4447,2321,137,2126,2,0.283643892,녹사평역1번출구,용산전쟁기념관,http://map.daum.net/?sName=녹사평역1번출구 대여소&eName=용산전쟁기념관 대여소&target=bicycle
811,813,195,117,4447,2321,78,2126,1,0.25,녹사평역1번출구,삼각지역 3번출구,http://map.daum.net/?sName=녹사평역1번출구 대여소&eName=삼각지역 3번출구 대여소&target=bicycle
1707,1708,164,98,4171,3645,66,526,1,0.251908397,도봉구민회관,보건소사거리(다비치안경창동점),http://map.daum.net/?sName=도봉구민회관 대여소&eName=보건소사거리(다비치안경창동점) 대여소&target=bicycle
3504,546,228,138,6893,6202,90,691,1,0.245901639,원일교회,잠실대교북단 교차로,http://map.daum.net/?sName=원일교회 대여소&eName=잠실대교북단 교차로 대여소&target=bicycle
509,546,79,151,11463,12376,-72,-913,1,0.313043478,이마트 버스정류소 옆,잠실대교북단 교차로,http://map.daum.net/?sName=이마트 버스정류소 옆 대여소&eName=잠실대교북단 교차로 대여소&target=bicycle
3504,548,178,116,6893,6202,62,691,1,0.210884354,원일교회,자양나들목,http://map.daum.net/?sName=원일교회 대여소&eName=자양나들목 대여소&target=bicycle
176,909,141,237,8730,9930,-96,-1200,1,0.253968254,명지대학교 도서관,백련산 힐스테이트 3차,http://map.daum.net/?sName=명지대학교 도서관 대여소&eName=백련산 힐스테이트 3차 대여소&target=bicycle
1024,1028,69,157,4478,4695,-88,-217,1,0.389380531,강동구청 앞,포레스 주상복합 빌딩,http://map.daum.net/?sName=강동구청 앞 대여소&eName=포레스 주상복합 빌딩 대여소&target=bicycle
1024,1030,192,113,4478,4695,79,-217,1,0.259016393,강동구청 앞,미호 플랜트 앞,http://map.daum.net/?sName=강동구청 앞 대여소&eName=미호 플랜트 앞 대여소&target=bicycle
2108,2119,172,261,5185,5464,-89,-279,1,0.205542725,은천치안센터,중앙동 동진빌딩,http://map.daum.net/?sName=은천치안센터 대여소&eName=중앙동 동진빌딩 대여소&target=bicycle
1343,1361,389,172,3030,2216,217,814,4,0.386809269,한성대7번출구 앞,홍익중고 입구,http://map.daum.net/?sName=한성대7번출구 앞 대여소&eName=홍익중고 입구 대여소&target=bicycle
1355,1361,147,65,8857,9887,82,-1030,1,0.386792453,보문2교,홍익중고 입구,http://map.daum.net/?sName=보문2교 대여소&eName=홍익중고 입구 대여소&target=bicycle
1355,388,77,127,8857,9887,-50,-1030,1,0.245098039,보문2교,동성중학교 앞,http://map.daum.net/?sName=보문2교 대여소&eName=동성중학교 앞 대여소&target=bicycle
341,388,83,142,6944,6197,-59,747,1,0.262222222,혜화역 3번출구 뒤,동성중학교 앞,http://map.daum.net/?sName=혜화역 3번출구 뒤 대여소&eName=동성중학교 앞 대여소&target=bicycle
107,413,69,156,12206,14037,-87,-1831,1,0.386666667,신한은행 서교동금융센터점 앞,상암월드컵파크 3단지 후문,http://map.daum.net/?sName=신한은행 서교동금융센터점 앞 대여소&eName=상암월드컵파크 3단지 후문 대여소&target=bicycle
157,160,74,167,7330,7936,-93,-606,1,0.385892116,애오개역 4번출구 앞,북아현동 가구거리,http://map.daum.net/?sName=애오개역 4번출구 앞 대여소&eName=북아현동 가구거리 대여소&target=bicycle
800,836,221,98,4354,5222,123,-868,2,0.385579937,목월공원 앞,현대자동차서비스 앞,http://map.daum.net/?sName=목월공원 앞 대여소&eName=현대자동차서비스 앞 대여소&target=bicycle
806,836,131,79,4266,3937,52,329,1,0.247619048,전자랜드 본관 앞,현대자동차서비스 앞,http://map.daum.net/?sName=전자랜드 본관 앞 대여소&eName=현대자동차서비스 앞 대여소&target=bicycle
2219,2279,83,187,26414,27015,-104,-601,2,0.385185185,"고속터미널역 8-1번, 8-2번 출구 사이",교대역 5번출구뒤,"http://map.daum.net/?sName=고속터미널역 8-1번, 8-2번 출구 사이 대여소&eName=교대역 5번출구뒤 대여소&target=bicycle"
2237,2279,199,114,4133,2877,85,1256,1,0.271565495,서울남부터미널 대합실 입구,교대역 5번출구뒤,http://map.daum.net/?sName=서울남부터미널 대합실 입구 대여소&eName=교대역 5번출구뒤 대여소&target=bicycle
2219,2271,153,69,26414,27015,84,-601,1,0.378378378,"고속터미널역 8-1번, 8-2번 출구 사이",내방역 8번출구 앞,"http://map.daum.net/?sName=고속터미널역 8-1번, 8-2번 출구 사이 대여소&eName=내방역 8번출구 앞 대여소&target=bicycle"
2219,2266,84,171,26414,27015,-87,-601,1,0.341176471,"고속터미널역 8-1번, 8-2번 출구 사이",서초역 3번출구,"http://map.daum.net/?sName=고속터미널역 8-1번, 8-2번 출구 사이 대여소&eName=서초역 3번출구 대여소&target=bicycle"
2219,2222,194,96,26414,27015,98,-601,1,0.337931034,"고속터미널역 8-1번, 8-2번 출구 사이",사당역 12번출구 뒤,"http://map.daum.net/?sName=고속터미널역 8-1번, 8-2번 출구 사이 대여소&eName=사당역 12번출구 뒤 대여소&target=bicycle"
2028,2222,176,362,3600,4498,-186,-898,3,0.345724907,남성역 2번출구 뒷편,사당역 12번출구 뒤,http://map.daum.net/?sName=남성역 2번출구 뒷편 대여소&eName=사당역 12번출구 뒤 대여소&target=bicycle
2048,2222,401,203,3426,2633,198,793,3,0.32781457,삼일초등학교 인근,사당역 12번출구 뒤,http://map.daum.net/?sName=삼일초등학교 인근 대여소&eName=사당역 12번출구 뒤 대여소&target=bicycle
2219,2268,106,194,26414,27015,-88,-601,1,0.293333333,"고속터미널역 8-1번, 8-2번 출구 사이",서초4동주민센터,"http://map.daum.net/?sName=고속터미널역 8-1번, 8-2번 출구 사이 대여소&eName=서초4동주민센터 대여소&target=bicycle"
2219,2239,80,143,26414,27015,-63,-601,1,0.282511211,"고속터미널역 8-1번, 8-2번 출구 사이",교대역 6번출구,"http://map.daum.net/?sName=고속터미널역 8-1번, 8-2번 출구 사이 대여소&eName=교대역 6번출구 대여소&target=bicycle"
2219,832,91,159,26414,27015,-68,-601,1,0.272,"고속터미널역 8-1번, 8-2번 출구 사이",이촌1동 주민센터 뒤,"http://map.daum.net/?sName=고속터미널역 8-1번, 8-2번 출구 사이 대여소&eName=이촌1동 주민센터 뒤 대여소&target=bicycle"
2219,2228,189,109,26414,27015,80,-601,1,0.268456376,"고속터미널역 8-1번, 8-2번 출구 사이",뒷벌공원 옆,"http://map.daum.net/?sName=고속터미널역 8-1번, 8-2번 출구 사이 대여소&eName=뒷벌공원 옆 대여소&target=bicycle"
2219,2277,265,171,26414,27015,94,-601,1,0.21559633,"고속터미널역 8-1번, 8-2번 출구 사이",길마중4교 하부,"http://map.daum.net/?sName=고속터미널역 8-1번, 8-2번 출구 사이 대여소&eName=길마중4교 하부 대여소&target=bicycle"
2262,2277,284,439,11700,13573,-155,-1873,3,0.214384509,한신16차아파트 119동 앞,길마중4교 하부,http://map.daum.net/?sName=한신16차아파트 119동 앞 대여소&eName=길마중4교 하부 대여소&target=bicycle
2219,2262,1100,728,26414,27015,372,-601,7,0.203501094,"고속터미널역 8-1번, 8-2번 출구 사이",한신16차아파트 119동 앞,"http://map.daum.net/?sName=고속터미널역 8-1번, 8-2번 출구 사이 대여소&eName=한신16차아파트 119동 앞 대여소&target=bicycle"
1139,1140,146,65,3721,3701,81,20,1,0.383886256,용문사 버스정류장,목동사거리 버스정류장,http://map.daum.net/?sName=용문사 버스정류장 대여소&eName=목동사거리 버스정류장 대여소&target=bicycle
1139,723,180,107,3721,3701,73,20,1,0.254355401,용문사 버스정류장,SBS방송국,http://map.daum.net/?sName=용문사 버스정류장 대여소&eName=SBS방송국 대여소&target=bicycle
1139,731,210,133,3721,3701,77,20,1,0.224489796,용문사 버스정류장,서울시 도로환경관리센터,http://map.daum.net/?sName=용문사 버스정류장 대여소&eName=서울시 도로환경관리센터 대여소&target=bicycle
1141,731,115,182,4548,6676,-67,-2128,1,0.225589226,곰달래 문화복지센터 1-1,서울시 도로환경관리센터,http://map.daum.net/?sName=곰달래 문화복지센터 1-1 대여소&eName=서울시 도로환경관리센터 대여소&target=bicycle
1140,731,204,123,3624,4089,81,-465,1,0.247706422,목동사거리 버스정류장,서울시 도로환경관리센터,http://map.daum.net/?sName=목동사거리 버스정류장 대여소&eName=서울시 도로환경관리센터 대여소&target=bicycle
346,375,168,308,8796,9250,-140,-454,2,0.294117647,맥스타일 앞,다산 어린이공원,http://map.daum.net/?sName=맥스타일 앞 대여소&eName=다산 어린이공원 대여소&target=bicycle
346,364,130,202,8796,9250,-72,-454,1,0.21686747,맥스타일 앞,창신역 1번출구 앞,http://map.daum.net/?sName=맥스타일 앞 대여소&eName=창신역 1번출구 앞 대여소&target=bicycle
2340,2358,86,193,5890,6271,-107,-381,2,0.383512545,삼호물산버스정류장(23370) 옆,구룡초사거리 (현대아파트10동 앞 ),http://map.daum.net/?sName=삼호물산버스정류장(23370) 옆 대여소&eName=구룡초사거리 (현대아파트10동 앞 ) 대여소&target=bicycle
1305,363,223,109,4475,4216,114,259,2,0.343373494,성북구청,신설동역 11번출구 뒤,http://map.daum.net/?sName=성북구청 대여소&eName=신설동역 11번출구 뒤 대여소&target=bicycle
339,363,107,162,7812,7486,-55,326,1,0.204460967,종로4가 사거리,신설동역 11번출구 뒤,http://map.daum.net/?sName=종로4가 사거리 대여소&eName=신설동역 11번출구 뒤 대여소&target=bicycle
362,363,112,192,6544,6723,-80,-179,1,0.263157895,청계8가 사거리,신설동역 11번출구 뒤,http://map.daum.net/?sName=청계8가 사거리 대여소&eName=신설동역 11번출구 뒤 대여소&target=bicycle
1006,1008,172,77,2730,2018,95,712,1,0.381526104,롯데캐슬 115동앞,암사역 3번출구(국민은행앞),http://map.daum.net/?sName=롯데캐슬 115동앞 대여소&eName=암사역 3번출구(국민은행앞) 대여소&target=bicycle
1003,1008,375,247,3867,3812,128,55,2,0.205787781,해공도서관앞,암사역 3번출구(국민은행앞),http://map.daum.net/?sName=해공도서관앞 대여소&eName=암사역 3번출구(국민은행앞) 대여소&target=bicycle
239,245,265,119,6606,6223,146,383,2,0.380208333,유스호스텔 앞,삼성생명 당산사옥 앞,http://map.daum.net/?sName=유스호스텔 앞 대여소&eName=삼성생명 당산사옥 앞 대여소&target=bicycle
230,245,364,203,12981,13114,161,-133,3,0.283950617,영등포구청역 1번출구,삼성생명 당산사옥 앞,http://map.daum.net/?sName=영등포구청역 1번출구 대여소&eName=삼성생명 당산사옥 앞 대여소&target=bicycle
1425,1447,178,80,2286,1788,98,498,1,0.379844961,용마문화복지센터,면목역 3번출구,http://map.daum.net/?sName=용마문화복지센터 대여소&eName=면목역 3번출구 대여소&target=bicycle
1440,1447,213,430,3779,4353,-217,-574,4,0.33748056,하나은행 면목지점,면목역 3번출구,http://map.daum.net/?sName=하나은행 면목지점 대여소&eName=면목역 3번출구 대여소&target=bicycle
1411,1447,212,109,2365,2399,103,-34,2,0.320872274,상봉시장앞 교차로 한성빌딩 앞,면목역 3번출구,http://map.daum.net/?sName=상봉시장앞 교차로 한성빌딩 앞 대여소&eName=면목역 3번출구 대여소&target=bicycle
1425,1456,138,81,2286,1788,57,498,1,0.260273973,용마문화복지센터,상아빌딩(우림시장 교차로),http://map.daum.net/?sName=용마문화복지센터 대여소&eName=상아빌딩(우림시장 교차로) 대여소&target=bicycle
1446,1456,135,65,4425,5090,70,-665,1,0.35,중랑전화국 교차로,상아빌딩(우림시장 교차로),http://map.daum.net/?sName=중랑전화국 교차로 대여소&eName=상아빌딩(우림시장 교차로) 대여소&target=bicycle
1411,1456,93,150,2365,2399,-57,-34,1,0.234567901,상봉시장앞 교차로 한성빌딩 앞,상아빌딩(우림시장 교차로),http://map.daum.net/?sName=상봉시장앞 교차로 한성빌딩 앞 대여소&eName=상아빌딩(우림시장 교차로) 대여소&target=bicycle
1318,1320,148,67,4786,4831,81,-45,1,0.376744186,길음역 3번출구 뒤,종암 농협지점 앞,http://map.daum.net/?sName=길음역 3번출구 뒤 대여소&eName=종암 농협지점 앞 대여소&target=bicycle
1318,1328,276,169,4786,4831,107,-45,2,0.240449438,길음역 3번출구 뒤,월곡역 3번출구,http://map.daum.net/?sName=길음역 3번출구 뒤 대여소&eName=월곡역 3번출구 대여소&target=bicycle
2237,2272,150,68,4133,2877,82,1256,1,0.376146789,서울남부터미널 대합실 입구,교대입구 교차로,http://map.daum.net/?sName=서울남부터미널 대합실 입구 대여소&eName=교대입구 교차로 대여소&target=bicycle
2266,2272,72,134,3742,3287,-62,455,1,0.300970874,서초역 3번출구,교대입구 교차로,http://map.daum.net/?sName=서초역 3번출구 대여소&eName=교대입구 교차로 대여소&target=bicycle
1962,1976,176,387,3654,3650,-211,4,4,0.374777975,가리봉동주민센터,남구로역 5번 출입구 앞,http://map.daum.net/?sName=가리봉동주민센터 대여소&eName=남구로역 5번 출입구 앞 대여소&target=bicycle
1001,1022,147,67,6934,7075,80,-141,1,0.373831776,광진교 남단 사거리(디지털프라자앞),길동 사거리(초소앞),http://map.daum.net/?sName=광진교 남단 사거리(디지털프라자앞) 대여소&eName=길동 사거리(초소앞) 대여소&target=bicycle
1019,1022,128,207,9845,11137,-79,-1292,1,0.235820896,다성이즈빌아파트(호원대 대각선 맞은편),길동 사거리(초소앞),http://map.daum.net/?sName=다성이즈빌아파트(호원대 대각선 맞은편) 대여소&eName=길동 사거리(초소앞) 대여소&target=bicycle
2015,237,185,85,6949,8246,100,-1297,2,0.37037037,신대방삼거리역 6번출구쪽,보라매 두산위브 건너편,http://map.daum.net/?sName=신대방삼거리역 6번출구쪽 대여소&eName=보라매 두산위브 건너편 대여소&target=bicycle
3501,514,150,69,8955,8414,81,541,1,0.369863014,광진구청 앞,성수사거리 버스정류장 앞,http://map.daum.net/?sName=광진구청 앞 대여소&eName=성수사거리 버스정류장 앞 대여소&target=bicycle
503,514,132,80,8329,7098,52,1231,1,0.245283019,더샵스타시티 C동 앞,성수사거리 버스정류장 앞,http://map.daum.net/?sName=더샵스타시티 C동 앞 대여소&eName=성수사거리 버스정류장 앞 대여소&target=bicycle
513,514,528,832,8826,9682,-304,-856,6,0.223529412,뚝섬역 5번 출구 정류소 옆,성수사거리 버스정류장 앞,http://map.daum.net/?sName=뚝섬역 5번 출구 정류소 옆 대여소&eName=성수사거리 버스정류장 앞 대여소&target=bicycle
3501,3523,224,142,8955,8414,82,541,1,0.224043716,광진구청 앞,건국대학교 과학관(이과대) 앞,http://map.daum.net/?sName=광진구청 앞 대여소&eName=건국대학교 과학관(이과대) 앞 대여소&target=bicycle
1141,719,112,243,4548,6676,-131,-2128,2,0.369014085,곰달래 문화복지센터 1-1,홍익병원앞 교차로,http://map.daum.net/?sName=곰달래 문화복지센터 1-1 대여소&eName=홍익병원앞 교차로 대여소&target=bicycle
702,719,95,154,2539,2426,-59,113,1,0.236947791,목4동주민센터 옆,홍익병원앞 교차로,http://map.daum.net/?sName=목4동주민센터 옆 대여소&eName=홍익병원앞 교차로 대여소&target=bicycle
1141,1146,155,92,4548,6676,63,-2128,1,0.255060729,곰달래 문화복지센터 1-1,곰달래사거리,http://map.daum.net/?sName=곰달래 문화복지센터 1-1 대여소&eName=곰달래사거리 대여소&target=bicycle
1128,1146,286,161,2844,2517,125,327,2,0.279642058,화곡역 6번출구,곰달래사거리,http://map.daum.net/?sName=화곡역 6번출구 대여소&eName=곰달래사거리 대여소&target=bicycle
1010,1026,65,141,7685,7616,-76,69,1,0.368932039,강동세무서,대명초교 입구 교차로,http://map.daum.net/?sName=강동세무서 대여소&eName=대명초교 입구 교차로 대여소&target=bicycle
1010,1024,168,80,7685,7616,88,69,1,0.35483871,강동세무서,강동구청 앞,http://map.daum.net/?sName=강동세무서 대여소&eName=강동구청 앞 대여소&target=bicycle
1010,1036,70,131,7685,7616,-61,69,1,0.303482587,강동세무서,고덕동 주양쇼핑,http://map.daum.net/?sName=강동세무서 대여소&eName=고덕동 주양쇼핑 대여소&target=bicycle
1010,1050,579,348,7685,7616,231,69,4,0.249190939,강동세무서,둔촌역 3번 출입구,http://map.daum.net/?sName=강동세무서 대여소&eName=둔촌역 3번 출입구 대여소&target=bicycle
1017,1050,119,180,5514,6269,-61,-755,1,0.204013378,맥도날드(길동),둔촌역 3번 출입구,http://map.daum.net/?sName=맥도날드(길동) 대여소&eName=둔촌역 3번 출입구 대여소&target=bicycle
309,311,218,135,5992,4473,83,1519,1,0.235127479,광화문역 6번출구 옆,서울광장 옆,http://map.daum.net/?sName=광화문역 6번출구 옆 대여소&eName=서울광장 옆 대여소&target=bicycle
303,311,327,581,8375,7554,-254,821,5,0.279735683,광화문역 1번출구 앞,서울광장 옆,http://map.daum.net/?sName=광화문역 1번출구 앞 대여소&eName=서울광장 옆 대여소&target=bicycle
308,311,315,555,4460,4300,-240,160,4,0.275862069,광화문 S타워 앞,서울광장 옆,http://map.daum.net/?sName=광화문 S타워 앞 대여소&eName=서울광장 옆 대여소&target=bicycle
1208,1215,101,171,6864,7353,-70,-489,1,0.257352941,풍납현대아파트쉼터,올림픽공원역 1번출구 앞,http://map.daum.net/?sName=풍납현대아파트쉼터 대여소&eName=올림픽공원역 1번출구 앞 대여소&target=bicycle
1207,1215,111,181,2964,4304,-70,-1340,1,0.239726027,마천CU우방점 앞,올림픽공원역 1번출구 앞,http://map.daum.net/?sName=마천CU우방점 앞 대여소&eName=올림픽공원역 1번출구 앞 대여소&target=bicycle
1208,1209,179,297,6864,7353,-118,-489,2,0.24789916,풍납현대아파트쉼터,잠실나루역 (2번 출구 쪽),http://map.daum.net/?sName=풍납현대아파트쉼터 대여소&eName=잠실나루역 (2번 출구 쪽) 대여소&target=bicycle
344,356,69,149,5724,5612,-80,112,1,0.366972477,성균관대 E하우스 앞,KT혜화지사 앞,http://map.daum.net/?sName=성균관대 E하우스 앞 대여소&eName=KT혜화지사 앞 대여소&target=bicycle
1306,356,208,97,7479,7356,111,123,2,0.363934426,한성대입구역2번출구,KT혜화지사 앞,http://map.daum.net/?sName=한성대입구역2번출구 대여소&eName=KT혜화지사 앞 대여소&target=bicycle
334,356,139,219,10121,9952,-80,169,1,0.223463687,종로3가역 2번출구 뒤,KT혜화지사 앞,http://map.daum.net/?sName=종로3가역 2번출구 뒤 대여소&eName=KT혜화지사 앞 대여소&target=bicycle
340,356,225,132,7930,7676,93,254,1,0.260504202,혜화동 로터리,KT혜화지사 앞,http://map.daum.net/?sName=혜화동 로터리 대여소&eName=KT혜화지사 앞 대여소&target=bicycle
344,346,138,75,5724,5612,63,112,1,0.295774648,성균관대 E하우스 앞,맥스타일 앞,http://map.daum.net/?sName=성균관대 E하우스 앞 대여소&eName=맥스타일 앞 대여소&target=bicycle
1351,346,78,135,7305,7727,-57,-422,1,0.267605634,SK제삼주유소 앞,맥스타일 앞,http://map.daum.net/?sName=SK제삼주유소 앞 대여소&eName=맥스타일 앞 대여소&target=bicycle
342,346,196,121,10534,10595,75,-61,1,0.23659306,대학로 마로니에공원,맥스타일 앞,http://map.daum.net/?sName=대학로 마로니에공원 대여소&eName=맥스타일 앞 대여소&target=bicycle
345,393,151,70,5640,5863,81,-223,1,0.366515837,서울보증보험본사 앞,동대문역 8번 출구,http://map.daum.net/?sName=서울보증보험본사 앞 대여소&eName=동대문역 8번 출구 대여소&target=bicycle
345,389,142,82,5640,5863,60,-223,1,0.267857143,서울보증보험본사 앞,을지로4가역 1번출구,http://map.daum.net/?sName=서울보증보험본사 앞 대여소&eName=을지로4가역 1번출구 대여소&target=bicycle
1106,1150,117,252,3503,3936,-135,-433,2,0.365853659,신방화사거리,송정역 1번출구,http://map.daum.net/?sName=신방화사거리 대여소&eName=송정역 1번출구 대여소&target=bicycle
2318,2355,230,108,3440,2514,122,926,2,0.360946746,삼성중앙역4번출구(문화센터더 리빌),삼성역 5~6번 출구 사이,http://map.daum.net/?sName=삼성중앙역4번출구(문화센터더 리빌) 대여소&eName=삼성역 5~6번 출구 사이 대여소&target=bicycle
1206,2355,96,146,8262,7754,-50,508,1,0.20661157,9호선종합운동장역 9번출구,삼성역 5~6번 출구 사이,http://map.daum.net/?sName=9호선종합운동장역 9번출구 대여소&eName=삼성역 5~6번 출구 사이 대여소&target=bicycle
2319,2355,206,119,2870,2800,87,70,1,0.267692308,포스코4거리 서측(수협 삼성동 지점),삼성역 5~6번 출구 사이,http://map.daum.net/?sName=포스코4거리 서측(수협 삼성동 지점) 대여소&eName=삼성역 5~6번 출구 사이 대여소&target=bicycle
615,641,213,99,5962,6070,114,-108,2,0.365384615,용두동 레미안허브리츠아파트 앞,용두역 4번출구,http://map.daum.net/?sName=용두동 레미안허브리츠아파트 앞 대여소&eName=용두역 4번출구 대여소&target=bicycle
568,641,159,88,11749,12342,71,-593,1,0.287449393,청계8가사거리 부근,용두역 4번출구,http://map.daum.net/?sName=청계8가사거리 부근 대여소&eName=용두역 4번출구 대여소&target=bicycle
550,641,93,158,4022,4113,-65,-91,1,0.258964143,서울시설공단 앞,용두역 4번출구,http://map.daum.net/?sName=서울시설공단 앞 대여소&eName=용두역 4번출구 대여소&target=bicycle
615,631,138,71,5962,6070,67,-108,1,0.320574163,용두동 레미안허브리츠아파트 앞,답십리역 1번출구,http://map.daum.net/?sName=용두동 레미안허브리츠아파트 앞 대여소&eName=답십리역 1번출구 대여소&target=bicycle
526,631,82,155,4830,5236,-73,-406,1,0.308016878,용답토속공원 앞,답십리역 1번출구,http://map.daum.net/?sName=용답토속공원 앞 대여소&eName=답십리역 1번출구 대여소&target=bicycle
630,631,117,207,5831,5890,-90,-59,1,0.277777778,동대문구 보건소,답십리역 1번출구,http://map.daum.net/?sName=동대문구 보건소 대여소&eName=답십리역 1번출구 대여소&target=bicycle
926,946,200,430,6546,6833,-230,-287,4,0.365079365,불광역 8번출구,독바위역,http://map.daum.net/?sName=불광역 8번출구 대여소&eName=독바위역 대여소&target=bicycle
1146,1157,87,187,3103,4576,-100,-1473,2,0.364963504,곰달래사거리,강서구청,http://map.daum.net/?sName=곰달래사거리 대여소&eName=강서구청 대여소&target=bicycle
1131,1157,297,139,5176,5803,158,-627,3,0.362385321,꿈돌이공원 앞,강서구청,http://map.daum.net/?sName=꿈돌이공원 앞 대여소&eName=강서구청 대여소&target=bicycle
1127,1157,224,121,4182,4098,103,84,2,0.298550725,화곡역(에이스정형외과앞) 버스정류장,강서구청,http://map.daum.net/?sName=화곡역(에이스정형외과앞) 버스정류장 대여소&eName=강서구청 대여소&target=bicycle
1120,1157,149,99,6161,7293,50,-1132,1,0.201612903,대림경동아파트앞,강서구청,http://map.daum.net/?sName=대림경동아파트앞 대여소&eName=강서구청 대여소&target=bicycle
1674,1721,146,68,5324,4596,78,728,1,0.364485981,서울북부고용센터앞,창동역 2번출구,http://map.daum.net/?sName=서울북부고용센터앞 대여소&eName=창동역 2번출구 대여소&target=bicycle
1662,1721,197,111,5118,3744,86,1374,1,0.279220779,노원역7번출구,창동역 2번출구,http://map.daum.net/?sName=노원역7번출구 대여소&eName=창동역 2번출구 대여소&target=bicycle
1674,1705,86,137,5324,4596,-51,728,1,0.228699552,서울북부고용센터앞,도봉구청 정문앞,http://map.daum.net/?sName=서울북부고용센터앞 대여소&eName=도봉구청 정문앞 대여소&target=bicycle
1440,1452,148,88,3779,4353,60,-574,1,0.254237288,하나은행 면목지점,겸재교 진입부,http://map.daum.net/?sName=하나은행 면목지점 대여소&eName=겸재교 진입부 대여소&target=bicycle
1447,1452,328,166,5317,5956,162,-639,3,0.327935223,면목역 3번출구,겸재교 진입부,http://map.daum.net/?sName=면목역 3번출구 대여소&eName=겸재교 진입부 대여소&target=bicycle
1306,341,190,99,7479,7356,91,123,1,0.314878893,한성대입구역2번출구,혜화역 3번출구 뒤,http://map.daum.net/?sName=한성대입구역2번출구 대여소&eName=혜화역 3번출구 뒤 대여소&target=bicycle
339,341,91,142,7812,7486,-51,326,1,0.21888412,종로4가 사거리,혜화역 3번출구 뒤,http://map.daum.net/?sName=종로4가 사거리 대여소&eName=혜화역 3번출구 뒤 대여소&target=bicycle
2332,2357,64,137,3113,3171,-73,-58,1,0.36318408,선릉역3번출구,르네상스호텔사거리 역삼지하보도 3번출구 앞 (더 오번 빌딩 명동칼국수 앞),http://map.daum.net/?sName=선릉역3번출구 대여소&eName=르네상스호텔사거리 역삼지하보도 3번출구 앞 (더 오번 빌딩 명동칼국수 앞) 대여소&target=bicycle
105,111,105,224,5689,4736,-119,953,2,0.361702128,합정역 5번출구 앞,상수역 2번출구 앞,http://map.daum.net/?sName=합정역 5번출구 앞 대여소&eName=상수역 2번출구 앞 대여소&target=bicycle
105,114,324,204,5689,4736,120,953,2,0.227272727,합정역 5번출구 앞,홍대입구역 8번출구 앞,http://map.daum.net/?sName=합정역 5번출구 앞 대여소&eName=홍대입구역 8번출구 앞 대여소&target=bicycle
111,114,312,153,8788,8233,159,555,3,0.341935484,상수역 2번출구 앞,홍대입구역 8번출구 앞,http://map.daum.net/?sName=상수역 2번출구 앞 대여소&eName=홍대입구역 8번출구 앞 대여소&target=bicycle
106,114,369,185,17613,16584,184,1029,3,0.332129964,합정역 7번출구 앞,홍대입구역 8번출구 앞,http://map.daum.net/?sName=합정역 7번출구 앞 대여소&eName=홍대입구역 8번출구 앞 대여소&target=bicycle
108,114,385,256,8583,8757,129,-174,2,0.20124805,서교동 사거리,홍대입구역 8번출구 앞,http://map.daum.net/?sName=서교동 사거리 대여소&eName=홍대입구역 8번출구 앞 대여소&target=bicycle
2248,2249,68,145,2384,2255,-77,129,1,0.361502347,서초리슈빌S 글로벌 앞,우솔초등학교 맞은편,http://map.daum.net/?sName=서초리슈빌S 글로벌 앞 대여소&eName=우솔초등학교 맞은편 대여소&target=bicycle
1407,1608,128,76,3707,4415,52,-708,1,0.254901961,먹골역 1번출구 뒤,공릉역 1번 출구 앞,http://map.daum.net/?sName=먹골역 1번출구 뒤 대여소&eName=공릉역 1번 출구 앞 대여소&target=bicycle
530,612,98,186,4597,5182,-88,-585,1,0.309859155,청계벽산아파트 앞,시립동부병원 앞 사거리,http://map.daum.net/?sName=청계벽산아파트 앞 대여소&eName=시립동부병원 앞 사거리 대여소&target=bicycle
557,612,167,104,4753,5089,63,-336,1,0.232472325,도선동 주민센터 앞,시립동부병원 앞 사거리,http://map.daum.net/?sName=도선동 주민센터 앞 대여소&eName=시립동부병원 앞 사거리 대여소&target=bicycle
530,614,242,160,4597,5182,82,-585,1,0.2039801,청계벽산아파트 앞,용두동 사거리,http://map.daum.net/?sName=청계벽산아파트 앞 대여소&eName=용두동 사거리 대여소&target=bicycle
568,614,342,226,11749,12342,116,-593,2,0.204225352,청계8가사거리 부근,용두동 사거리,http://map.daum.net/?sName=청계8가사거리 부근 대여소&eName=용두동 사거리 대여소&target=bicycle
731,752,80,170,7338,7829,-90,-491,1,0.36,서울시 도로환경관리센터,성원2차 아파트,http://map.daum.net/?sName=서울시 도로환경관리센터 대여소&eName=성원2차 아파트 대여소&target=bicycle
723,752,98,203,8474,9143,-105,-669,2,0.348837209,SBS방송국,성원2차 아파트,http://map.daum.net/?sName=SBS방송국 대여소&eName=성원2차 아파트 대여소&target=bicycle
3515,510,281,479,11085,11260,-198,-175,3,0.260526316,서울숲 관리사무소,서울숲 남문 버스정류소 옆,http://map.daum.net/?sName=서울숲 관리사무소 대여소&eName=서울숲 남문 버스정류소 옆 대여소&target=bicycle
3515,561,200,309,11085,11260,-109,-175,2,0.214145383,서울숲 관리사무소,서울숲역 2번출구 앞,http://map.daum.net/?sName=서울숲 관리사무소 대여소&eName=서울숲역 2번출구 앞 대여소&target=bicycle
1220,1233,70,148,6741,7523,-78,-782,1,0.357798165,잠실본동주민센터뒤 잠실근린공원,잠실3거리(갤러리아팰리스),http://map.daum.net/?sName=잠실본동주민센터뒤 잠실근린공원 대여소&eName=잠실3거리(갤러리아팰리스) 대여소&target=bicycle
1221,1233,191,307,8629,11466,-116,-2837,2,0.232931727,삼전사거리 포스코더샵,잠실3거리(갤러리아팰리스),http://map.daum.net/?sName=삼전사거리 포스코더샵 대여소&eName=잠실3거리(갤러리아팰리스) 대여소&target=bicycle
1232,1233,130,78,4892,4744,52,148,1,0.25,롯데마트 주차장 옆,잠실3거리(갤러리아팰리스),http://map.daum.net/?sName=롯데마트 주차장 옆 대여소&eName=잠실3거리(갤러리아팰리스) 대여소&target=bicycle
1804,1847,137,65,3294,3158,72,136,1,0.356435644,독산역 2번출구 자전거주차장,독산주공 14단지 버스정류소,http://map.daum.net/?sName=독산역 2번출구 자전거주차장 대여소&eName=독산주공 14단지 버스정류소 대여소&target=bicycle
1804,1809,232,146,3294,3158,86,136,1,0.227513228,독산역 2번출구 자전거주차장,LG전자 별관동(호서대 벤처타워 맞은편),http://map.daum.net/?sName=독산역 2번출구 자전거주차장 대여소&eName=LG전자 별관동(호서대 벤처타워 맞은편) 대여소&target=bicycle
1221,2324,92,164,8629,11466,-72,-2837,1,0.28125,삼전사거리 포스코더샵,천주교 대치 2동 교회 옆,http://map.daum.net/?sName=삼전사거리 포스코더샵 대여소&eName=천주교 대치 2동 교회 옆 대여소&target=bicycle
1222,2324,79,142,19141,19511,-63,-370,1,0.285067873,잠실새내역 5번 출구 뒤,천주교 대치 2동 교회 옆,http://map.daum.net/?sName=잠실새내역 5번 출구 뒤 대여소&eName=천주교 대치 2동 교회 옆 대여소&target=bicycle
1241,2384,163,78,2097,1681,85,416,1,0.352697095,문정 법조단지5,자곡사거리,http://map.daum.net/?sName=문정 법조단지5 대여소&eName=자곡사거리 대여소&target=bicycle
1240,2384,163,91,2466,2354,72,112,1,0.283464567,문정 법조단지4,자곡사거리,http://map.daum.net/?sName=문정 법조단지4 대여소&eName=자곡사거리 대여소&target=bicycle
210,215,134,84,20427,20741,50,-314,1,0.229357798,IFC몰,여의도고교 앞,http://map.daum.net/?sName=IFC몰 대여소&eName=여의도고교 앞 대여소&target=bicycle
2002,215,160,87,15126,17605,73,-2479,1,0.295546559,노들역 1번출구,여의도고교 앞,http://map.daum.net/?sName=노들역 1번출구 대여소&eName=여의도고교 앞 대여소&target=bicycle
3505,3506,142,85,5644,4650,57,994,1,0.251101322,신양초교앞 교차로,영동대교 북단,http://map.daum.net/?sName=신양초교앞 교차로 대여소&eName=영동대교 북단 대여소&target=bicycle
514,560,181,307,11672,12181,-126,-509,2,0.258196721,성수사거리 버스정류장 앞,비전교회 앞,http://map.daum.net/?sName=성수사거리 버스정류장 앞 대여소&eName=비전교회 앞 대여소&target=bicycle
509,560,145,71,11463,12376,74,-913,1,0.342592593,이마트 버스정류소 옆,비전교회 앞,http://map.daum.net/?sName=이마트 버스정류소 옆 대여소&eName=비전교회 앞 대여소&target=bicycle
1702,1714,127,264,3425,4607,-137,-1182,2,0.350383632,녹천역 1번출구 앞,도봉문화정보도서관 삼거리,http://map.daum.net/?sName=녹천역 1번출구 앞 대여소&eName=도봉문화정보도서관 삼거리 대여소&target=bicycle
2276,2285,78,162,3506,3383,-84,123,1,0.35,영동1교 (양재천근린공원),LH서초3단지 301동 맞은편,http://map.daum.net/?sName=영동1교 (양재천근린공원) 대여소&eName=LH서초3단지 301동 맞은편 대여소&target=bicycle
1122,1123,104,158,8709,9721,-54,-1012,1,0.20610687,황금내근린공원,공암나루근린공원 관리사무소옆,http://map.daum.net/?sName=황금내근린공원 대여소&eName=공암나루근린공원 관리사무소옆 대여소&target=bicycle
1617,1668,73,151,3373,4305,-78,-932,1,0.348214286,하계동 중평어린이공원 앞,중계역 6번출구,http://map.daum.net/?sName=하계동 중평어린이공원 앞 대여소&eName=중계역 6번출구 대여소&target=bicycle
1661,1668,152,92,3350,3160,60,190,1,0.245901639,당현천근린공원,중계역 6번출구,http://map.daum.net/?sName=당현천근린공원 대여소&eName=중계역 6번출구 대여소&target=bicycle
1617,1636,101,173,3373,4305,-72,-932,1,0.262773723,하계동 중평어린이공원 앞,백병원 사거리 농협은행 앞,http://map.daum.net/?sName=하계동 중평어린이공원 앞 대여소&eName=백병원 사거리 농협은행 앞 대여소&target=bicycle
1625,1636,228,133,11449,11180,95,269,1,0.263157895,상계역(4번출구),백병원 사거리 농협은행 앞,http://map.daum.net/?sName=상계역(4번출구) 대여소&eName=백병원 사거리 농협은행 앞 대여소&target=bicycle
1833,1850,151,73,3008,3415,78,-407,1,0.348214286,독산역 1번출구 앞 자전거보관소,코오롱테크노밸리,http://map.daum.net/?sName=독산역 1번출구 앞 자전거보관소 대여소&eName=코오롱테크노밸리 대여소&target=bicycle
1833,1839,139,249,3008,3415,-110,-407,2,0.283505155,독산역 1번출구 앞 자전거보관소,수출의 다리 아래,http://map.daum.net/?sName=독산역 1번출구 앞 자전거보관소 대여소&eName=수출의 다리 아래 대여소&target=bicycle
1830,1839,195,394,3568,3851,-199,-283,3,0.337860781,빅마켓 금천점 앞,수출의 다리 아래,http://map.daum.net/?sName=빅마켓 금천점 앞 대여소&eName=수출의 다리 아래 대여소&target=bicycle
303,321,128,73,8375,7554,55,821,1,0.273631841,광화문역 1번출구 앞,KEB 하나은행 본점 앞,http://map.daum.net/?sName=광화문역 1번출구 앞 대여소&eName=KEB 하나은행 본점 앞 대여소&target=bicycle
303,316,233,359,8375,7554,-126,821,2,0.212837838,광화문역 1번출구 앞,종각역 1번출구 앞,http://map.daum.net/?sName=광화문역 1번출구 앞 대여소&eName=종각역 1번출구 앞 대여소&target=bicycle
303,351,200,307,8375,7554,-107,821,2,0.211045365,광화문역 1번출구 앞,청운초교 앞 삼거리,http://map.daum.net/?sName=광화문역 1번출구 앞 대여소&eName=청운초교 앞 삼거리 대여소&target=bicycle
304,351,127,73,5979,5598,54,381,1,0.27,광화문역 2번출구 앞,청운초교 앞 삼거리,http://map.daum.net/?sName=광화문역 2번출구 앞 대여소&eName=청운초교 앞 삼거리 대여소&target=bicycle
1955,2140,78,161,8237,8018,-83,219,1,0.347280335,디지털입구 교차로,신림1교 교차로,http://map.daum.net/?sName=디지털입구 교차로 대여소&eName=신림1교 교차로 대여소&target=bicycle
2113,2140,172,89,6268,6156,83,112,1,0.318007663,관악동작견인차량보관소,신림1교 교차로,http://map.daum.net/?sName=관악동작견인차량보관소 대여소&eName=신림1교 교차로 대여소&target=bicycle
1955,2157,156,103,8237,8018,53,219,1,0.204633205,디지털입구 교차로,난곡 사거리,http://map.daum.net/?sName=디지털입구 교차로 대여소&eName=난곡 사거리 대여소&target=bicycle
2156,2157,186,119,2797,2734,67,63,1,0.219672131,농협 관악문성지점,난곡 사거리,http://map.daum.net/?sName=농협 관악문성지점 대여소&eName=난곡 사거리 대여소&target=bicycle
1503,1516,66,136,9842,10332,-70,-490,1,0.346534653,이디야 커피 수유역점 앞,우이초등학교 후문 옆,http://map.daum.net/?sName=이디야 커피 수유역점 앞 대여소&eName=우이초등학교 후문 옆 대여소&target=bicycle
1503,1506,295,457,9842,10332,-162,-490,3,0.215425532,이디야 커피 수유역점 앞,강북문화예술회관,http://map.daum.net/?sName=이디야 커피 수유역점 앞 대여소&eName=강북문화예술회관 대여소&target=bicycle
2028,2104,207,128,3600,4498,79,-898,1,0.235820896,남성역 2번출구 뒷편,사당역 5번출구,http://map.daum.net/?sName=남성역 2번출구 뒷편 대여소&eName=사당역 5번출구 대여소&target=bicycle
2028,2230,168,261,3600,4498,-93,-898,1,0.216783217,남성역 2번출구 뒷편,이수역 4번 출구,http://map.daum.net/?sName=남성역 2번출구 뒷편 대여소&eName=이수역 4번 출구 대여소&target=bicycle
1014,1041,162,98,4169,3409,64,760,1,0.246153846,강동구평생학습관앞,묘곡초등학교,http://map.daum.net/?sName=강동구평생학습관앞 대여소&eName=묘곡초등학교 대여소&target=bicycle
1627,1637,150,73,2716,2824,77,-108,1,0.34529148,수락산역 4번출구,KT 노원점 건물 앞,http://map.daum.net/?sName=수락산역 4번출구 대여소&eName=KT 노원점 건물 앞 대여소&target=bicycle
1627,1628,170,90,2716,2824,80,-108,1,0.307692308,수락산역 4번출구,노일초등학교 앞,http://map.daum.net/?sName=수락산역 4번출구 대여소&eName=노일초등학교 앞 대여소&target=bicycle
1408,1446,76,156,4632,5817,-80,-1185,1,0.344827586,먹골역 6번출구 앞,중랑전화국 교차로,http://map.daum.net/?sName=먹골역 6번출구 앞 대여소&eName=중랑전화국 교차로 대여소&target=bicycle
1414,1446,173,107,5941,7267,66,-1326,1,0.235714286,사가정역 1번출구,중랑전화국 교차로,http://map.daum.net/?sName=사가정역 1번출구 대여소&eName=중랑전화국 교차로 대여소&target=bicycle
1606,1643,197,96,7201,7671,101,-470,2,0.344709898,태릉입구역 3번출구,태릉입구역 8번출구,http://map.daum.net/?sName=태릉입구역 3번출구 대여소&eName=태릉입구역 8번출구 대여소&target=bicycle
1610,1643,250,157,9167,10060,93,-893,1,0.228501229,화랑대역 2번출구 앞,태릉입구역 8번출구,http://map.daum.net/?sName=화랑대역 2번출구 앞 대여소&eName=태릉입구역 8번출구 대여소&target=bicycle
1606,1642,125,244,7201,7671,-119,-470,2,0.322493225,태릉입구역 3번출구,서울여대 남문,http://map.daum.net/?sName=태릉입구역 3번출구 대여소&eName=서울여대 남문 대여소&target=bicycle
567,585,182,89,11747,10650,93,1097,1,0.343173432,성수역 2번출구 앞,성수2가1동 공영주차장 인근,http://map.daum.net/?sName=성수역 2번출구 앞 대여소&eName=성수2가1동 공영주차장 인근 대여소&target=bicycle
3506,585,333,180,3956,4320,153,-364,3,0.298245614,영동대교 북단,성수2가1동 공영주차장 인근,http://map.daum.net/?sName=영동대교 북단 대여소&eName=성수2가1동 공영주차장 인근 대여소&target=bicycle
582,585,99,161,4214,4238,-62,-24,1,0.238461538,경일중학교 앞,성수2가1동 공영주차장 인근,http://map.daum.net/?sName=경일중학교 앞 대여소&eName=성수2가1동 공영주차장 인근 대여소&target=bicycle
1602,1671,192,94,3589,3271,98,318,1,0.342657343,광운대역 앞,인덕대학교,http://map.daum.net/?sName=광운대역 앞 대여소&eName=인덕대학교 대여소&target=bicycle
1602,1603,197,108,3589,3271,89,318,1,0.291803279,광운대역 앞,롯데캐슬 102동 코너(월계주유소건너),http://map.daum.net/?sName=광운대역 앞 대여소&eName=롯데캐슬 102동 코너(월계주유소건너) 대여소&target=bicycle
1601,1603,466,301,10961,10529,165,432,3,0.215123859,석계역 문화광장 내 자전거 보관소,롯데캐슬 102동 코너(월계주유소건너),http://map.daum.net/?sName=석계역 문화광장 내 자전거 보관소 대여소&eName=롯데캐슬 102동 코너(월계주유소건너) 대여소&target=bicycle
2361,2363,73,149,3734,3348,-76,386,1,0.342342342,압구정역 교차로,강남 을지병원 교차로,http://map.daum.net/?sName=압구정역 교차로 대여소&eName=강남 을지병원 교차로 대여소&target=bicycle
1214,1283,137,279,4871,4823,-142,48,2,0.341346154,오금역 7번 출구 인근,오금공원 사거리,http://map.daum.net/?sName=오금역 7번 출구 인근 대여소&eName=오금공원 사거리 대여소&target=bicycle
1214,1259,293,155,4871,4823,138,48,2,0.308035714,오금역 7번 출구 인근,방이역 1번출구,http://map.daum.net/?sName=오금역 7번 출구 인근 대여소&eName=방이역 1번출구 대여소&target=bicycle
1011,1259,83,133,10393,10422,-50,-29,1,0.231481481,LIGA 아파트 앞,방이역 1번출구,http://map.daum.net/?sName=LIGA 아파트 앞 대여소&eName=방이역 1번출구 대여소&target=bicycle
1251,1259,75,133,9579,9782,-58,-203,1,0.278846154,석촌역 2번출구,방이역 1번출구,http://map.daum.net/?sName=석촌역 2번출구 대여소&eName=방이역 1번출구 대여소&target=bicycle
2110,2170,90,183,3053,2824,-93,229,1,0.340659341,조원동 미성아파트,조원동서울본병원,http://map.daum.net/?sName=조원동 미성아파트 대여소&eName=조원동서울본병원 대여소&target=bicycle
2003,2015,148,73,7661,7766,75,-105,1,0.339366516,사육신공원앞,신대방삼거리역 6번출구쪽,http://map.daum.net/?sName=사육신공원앞 대여소&eName=신대방삼거리역 6번출구쪽 대여소&target=bicycle
1009,1208,371,217,12114,11462,154,652,3,0.261904762,천호역4번출구(현대백화점),풍납현대아파트쉼터,http://map.daum.net/?sName=천호역4번출구(현대백화점) 대여소&eName=풍납현대아파트쉼터 대여소&target=bicycle
1030,1208,152,234,4277,4388,-82,-111,1,0.212435233,미호 플랜트 앞,풍납현대아파트쉼터,http://map.daum.net/?sName=미호 플랜트 앞 대여소&eName=풍납현대아파트쉼터 대여소&target=bicycle
1941,1973,164,330,2285,3054,-166,-769,3,0.336032389,오류동역 2번출구,오리로와 서해안도로 교차로 앞,http://map.daum.net/?sName=오류동역 2번출구 대여소&eName=오리로와 서해안도로 교차로 앞 대여소&target=bicycle
612,615,84,169,5698,6064,-85,-366,1,0.335968379,시립동부병원 앞 사거리,용두동 레미안허브리츠아파트 앞,http://map.daum.net/?sName=시립동부병원 앞 사거리 대여소&eName=용두동 레미안허브리츠아파트 앞 대여소&target=bicycle
609,615,293,182,6374,6367,111,7,2,0.233684211,제기2교,용두동 레미안허브리츠아파트 앞,http://map.daum.net/?sName=제기2교 대여소&eName=용두동 레미안허브리츠아파트 앞 대여소&target=bicycle
2032,2048,770,1545,5982,6830,-775,-848,15,0.334773218,이수역 11번출구쪽,삼일초등학교 인근,http://map.daum.net/?sName=이수역 11번출구쪽 대여소&eName=삼일초등학교 인근 대여소&target=bicycle
2034,2048,93,165,4161,4636,-72,-475,1,0.279069767,사당역 7번출구쪽,삼일초등학교 인근,http://map.daum.net/?sName=사당역 7번출구쪽 대여소&eName=삼일초등학교 인근 대여소&target=bicycle
2032,2265,212,120,5982,6830,92,-848,1,0.277108434,이수역 11번출구쪽,이수고가차도 남단,http://map.daum.net/?sName=이수역 11번출구쪽 대여소&eName=이수고가차도 남단 대여소&target=bicycle
2032,2062,152,256,5982,6830,-104,-848,2,0.254901961,이수역 11번출구쪽,사당새마을금고,http://map.daum.net/?sName=이수역 11번출구쪽 대여소&eName=사당새마을금고 대여소&target=bicycle
2139,2143,209,391,12535,13756,-182,-1221,3,0.303333333,서울신성초등학교,서울산업정보학교,http://map.daum.net/?sName=서울신성초등학교 대여소&eName=서울산업정보학교 대여소&target=bicycle
2139,2172,367,583,12535,13756,-216,-1221,4,0.227368421,서울신성초등학교,나들목공원,http://map.daum.net/?sName=서울신성초등학교 대여소&eName=나들목공원 대여소&target=bicycle
2141,2172,145,240,10050,10582,-95,-532,1,0.246753247,미림여고입구 교차로,나들목공원,http://map.daum.net/?sName=미림여고입구 교차로 대여소&eName=나들목공원 대여소&target=bicycle
1673,1712,226,113,8038,7747,113,291,2,0.333333333,노원역 5번출구,창동역공영주차장앞,http://map.daum.net/?sName=노원역 5번출구 대여소&eName=창동역공영주차장앞 대여소&target=bicycle
1706,1712,96,146,4312,5011,-50,-699,1,0.20661157,기업은행 앞,창동역공영주차장앞,http://map.daum.net/?sName=기업은행 앞 대여소&eName=창동역공영주차장앞 대여소&target=bicycle
106,112,444,296,17613,16584,148,1029,2,0.2,합정역 7번출구 앞,극동방송국 앞,http://map.daum.net/?sName=합정역 7번출구 앞 대여소&eName=극동방송국 앞 대여소&target=bicycle
103,112,220,128,10248,9142,92,1106,1,0.264367816,망원역 2번출구 앞,극동방송국 앞,http://map.daum.net/?sName=망원역 2번출구 앞 대여소&eName=극동방송국 앞 대여소&target=bicycle
2262,2303,70,139,11700,13573,-69,-1873,1,0.330143541,한신16차아파트 119동 앞,논현역 7번출구,http://map.daum.net/?sName=한신16차아파트 119동 앞 대여소&eName=논현역 7번출구 대여소&target=bicycle
2301,2303,135,215,11870,12222,-80,-352,1,0.228571429,현대고등학교 건너편,논현역 7번출구,http://map.daum.net/?sName=현대고등학교 건너편 대여소&eName=논현역 7번출구 대여소&target=bicycle
341,344,390,225,6944,6197,165,747,3,0.268292683,혜화역 3번출구 뒤,성균관대 E하우스 앞,http://map.daum.net/?sName=혜화역 3번출구 뒤 대여소&eName=성균관대 E하우스 앞 대여소&target=bicycle
253,255,610,308,3617,3840,302,-223,6,0.328976035,신풍역 5번출구 인근,도림4거리,http://map.daum.net/?sName=신풍역 5번출구 인근 대여소&eName=도림4거리 대여소&target=bicycle
253,254,151,85,3617,3840,66,-223,1,0.279661017,신풍역 5번출구 인근,도림신협 앞,http://map.daum.net/?sName=신풍역 5번출구 인근 대여소&eName=도림신협 앞 대여소&target=bicycle
234,254,152,95,2556,2750,57,-194,1,0.230769231,영등포구민체육센터 앞,도림신협 앞,http://map.daum.net/?sName=영등포구민체육센터 앞 대여소&eName=도림신협 앞 대여소&target=bicycle
1210,1213,128,253,27973,28094,-125,-121,2,0.32808399,롯데월드타워(잠실역2번출구 쪽),백토공원 앞,http://map.daum.net/?sName=롯데월드타워(잠실역2번출구 쪽) 대여소&eName=백토공원 앞 대여소&target=bicycle
1210,1243,107,211,27973,28094,-104,-121,2,0.327044025,롯데월드타워(잠실역2번출구 쪽),문정 법조단지7,http://map.daum.net/?sName=롯데월드타워(잠실역2번출구 쪽) 대여소&eName=문정 법조단지7 대여소&target=bicycle
1212,1243,282,179,6783,7281,103,-498,2,0.223427332,송파역 2번 출구앞,문정 법조단지7,http://map.daum.net/?sName=송파역 2번 출구앞 대여소&eName=문정 법조단지7 대여소&target=bicycle
1217,1243,390,213,4407,4548,177,-141,3,0.293532338,송파파인타운 7단지,문정 법조단지7,http://map.daum.net/?sName=송파파인타운 7단지 대여소&eName=문정 법조단지7 대여소&target=bicycle
1210,1248,658,1087,27973,28094,-429,-121,8,0.245845272,롯데월드타워(잠실역2번출구 쪽),방이초등학교,http://map.daum.net/?sName=롯데월드타워(잠실역2번출구 쪽) 대여소&eName=방이초등학교 대여소&target=bicycle
1215,1248,188,311,13238,13815,-123,-577,2,0.246492986,올림픽공원역 1번출구 앞,방이초등학교,http://map.daum.net/?sName=올림픽공원역 1번출구 앞 대여소&eName=방이초등학교 대여소&target=bicycle
301,302,163,101,7911,6220,62,1691,1,0.234848485,경복궁역 7번출구 앞,경복궁역 4번출구 뒤,http://map.daum.net/?sName=경복궁역 7번출구 앞 대여소&eName=경복궁역 4번출구 뒤 대여소&target=bicycle
103,108,216,126,10248,9142,90,1106,1,0.263157895,망원역 2번출구 앞,서교동 사거리,http://map.daum.net/?sName=망원역 2번출구 앞 대여소&eName=서교동 사거리 대여소&target=bicycle
503,504,605,399,8329,7098,206,1231,4,0.205179283,더샵스타시티 C동 앞,신자초교입구교차로,http://map.daum.net/?sName=더샵스타시티 C동 앞 대여소&eName=신자초교입구교차로 대여소&target=bicycle
3506,504,152,95,3956,4320,57,-364,1,0.230769231,영동대교 북단,신자초교입구교차로,http://map.daum.net/?sName=영동대교 북단 대여소&eName=신자초교입구교차로 대여소&target=bicycle
1321,636,206,105,7607,7623,101,-16,2,0.324758842,국민은행 종암동지점 앞,세종대왕기념관 교차로,http://map.daum.net/?sName=국민은행 종암동지점 앞 대여소&eName=세종대왕기념관 교차로 대여소&target=bicycle
1610,1679,292,572,9167,10060,-280,-893,5,0.324074074,화랑대역 2번출구 앞,삼육대 도서관,http://map.daum.net/?sName=화랑대역 2번출구 앞 대여소&eName=삼육대 도서관 대여소&target=bicycle
1123,1155,98,191,6092,6468,-93,-376,1,0.321799308,공암나루근린공원 관리사무소옆,기쁜우리복지관,http://map.daum.net/?sName=공암나루근린공원 관리사무소옆 대여소&eName=기쁜우리복지관 대여소&target=bicycle
1117,1155,107,163,6916,7260,-56,-344,1,0.207407407,스타벅스앞,기쁜우리복지관,http://map.daum.net/?sName=스타벅스앞 대여소&eName=기쁜우리복지관 대여소&target=bicycle
334,335,135,83,10121,9952,52,169,1,0.23853211,종로3가역 2번출구 뒤,종로3가역 15번출구 앞,http://map.daum.net/?sName=종로3가역 2번출구 뒤 대여소&eName=종로3가역 15번출구 앞 대여소&target=bicycle
1512,1518,110,214,4534,5099,-104,-565,2,0.320987654,강북중학교 앞,SK telecom(수유직영점) 앞,http://map.daum.net/?sName=강북중학교 앞 대여소&eName=SK telecom(수유직영점) 앞 대여소&target=bicycle
1512,1520,87,160,4534,5099,-73,-565,1,0.295546559,강북중학교 앞,성실교회,http://map.daum.net/?sName=강북중학교 앞 대여소&eName=성실교회 대여소&target=bicycle
1002,1003,134,259,4650,5667,-125,-1017,2,0.318066158,해공공원(천호동),해공도서관앞,http://map.daum.net/?sName=해공공원(천호동) 대여소&eName=해공도서관앞 대여소&target=bicycle
1414,627,195,101,5941,7267,94,-1326,1,0.317567568,사가정역 1번출구,장안동삼거리 교통섬,http://map.daum.net/?sName=사가정역 1번출구 대여소&eName=장안동삼거리 교통섬 대여소&target=bicycle
1414,1434,208,137,5941,7267,71,-1326,1,0.205797101,사가정역 1번출구,홈플러스 면목동점,http://map.daum.net/?sName=사가정역 1번출구 대여소&eName=홈플러스 면목동점 대여소&target=bicycle
1003,1011,83,160,3867,3812,-77,55,1,0.316872428,해공도서관앞,LIGA 아파트 앞,http://map.daum.net/?sName=해공도서관앞 대여소&eName=LIGA 아파트 앞 대여소&target=bicycle
1243,1246,349,205,9277,9808,144,-531,2,0.259927798,문정 법조단지7,문정 법조단지10,http://map.daum.net/?sName=문정 법조단지7 대여소&eName=문정 법조단지10 대여소&target=bicycle
1243,1245,406,663,9277,9808,-257,-531,5,0.2404116,문정 법조단지7,문정 법조단지9,http://map.daum.net/?sName=문정 법조단지7 대여소&eName=문정 법조단지9 대여소&target=bicycle
1428,1450,203,106,3701,2656,97,1045,1,0.313915858,원묵고등학교,화랑대역 7번출구,http://map.daum.net/?sName=원묵고등학교 대여소&eName=화랑대역 7번출구 대여소&target=bicycle
1431,1450,148,92,4852,4696,56,156,1,0.233333333,중랑구청 사거리,화랑대역 7번출구,http://map.daum.net/?sName=중랑구청 사거리 대여소&eName=화랑대역 7번출구 대여소&target=bicycle
101,102,92,152,3994,4062,-60,-68,1,0.245901639,(구)합정동 주민센터,망원역 1번출구 앞,http://map.daum.net/?sName=(구)합정동 주민센터 대여소&eName=망원역 1번출구 앞 대여소&target=bicycle
311,818,154,81,12978,9711,73,3267,1,0.310638298,서울광장 옆,숙명여대 입구 교차로,http://map.daum.net/?sName=서울광장 옆 대여소&eName=숙명여대 입구 교차로 대여소&target=bicycle
1924,1955,408,215,2524,1539,193,985,3,0.309791332,삼부르네상스파크빌,디지털입구 교차로,http://map.daum.net/?sName=삼부르네상스파크빌 대여소&eName=디지털입구 교차로 대여소&target=bicycle
1828,1955,218,134,2102,1581,84,521,1,0.238636364,한양수자인아파트 앞,디지털입구 교차로,http://map.daum.net/?sName=한양수자인아파트 앞 대여소&eName=디지털입구 교차로 대여소&target=bicycle
1829,1955,114,172,2954,3245,-58,-291,1,0.202797203,홈플러스 금천점 앞,디지털입구 교차로,http://map.daum.net/?sName=홈플러스 금천점 앞 대여소&eName=디지털입구 교차로 대여소&target=bicycle
2056,252,328,173,5366,5147,155,219,3,0.309381238,동작구민 체육센터,보라매역4번출구,http://map.daum.net/?sName=동작구민 체육센터 대여소&eName=보라매역4번출구 대여소&target=bicycle
2320,2325,95,180,4067,4067,-85,0,1,0.309090909,도곡역 대치지구대 방향,대치동 버거킹대치점,http://map.daum.net/?sName=도곡역 대치지구대 방향 대여소&eName=대치동 버거킹대치점 대여소&target=bicycle
2320,2321,115,215,4067,4067,-100,0,2,0.303030303,도곡역 대치지구대 방향,학여울역 사거리,http://map.daum.net/?sName=도곡역 대치지구대 방향 대여소&eName=학여울역 사거리 대여소&target=bicycle
2320,2335,273,182,4067,4067,91,0,1,0.2,도곡역 대치지구대 방향,3호선 매봉역 3번출구앞,http://map.daum.net/?sName=도곡역 대치지구대 방향 대여소&eName=3호선 매봉역 3번출구앞 대여소&target=bicycle
2241,2335,159,97,2556,2275,62,281,1,0.2421875,양재전화국 사거리,3호선 매봉역 3번출구앞,http://map.daum.net/?sName=양재전화국 사거리 대여소&eName=3호선 매봉역 3번출구앞 대여소&target=bicycle
1035,1049,161,85,6945,5620,76,1325,1,0.308943089,고덕역 4번출구,강일동 10단지 아파트,http://map.daum.net/?sName=고덕역 4번출구 대여소&eName=강일동 10단지 아파트 대여소&target=bicycle
1035,1042,139,76,6945,5620,63,1325,1,0.293023256,고덕역 4번출구,강일 2.5단지 사이,http://map.daum.net/?sName=고덕역 4번출구 대여소&eName=강일 2.5단지 사이 대여소&target=bicycle
1228,1282,134,71,3401,4145,63,-744,1,0.307317073,마천사거리,송파소방서 맞은편(성내4교),http://map.daum.net/?sName=마천사거리 대여소&eName=송파소방서 맞은편(성내4교) 대여소&target=bicycle
2301,2306,159,299,11870,12222,-140,-352,2,0.305676856,현대고등학교 건너편,압구정역 2번 출구 옆,http://map.daum.net/?sName=현대고등학교 건너편 대여소&eName=압구정역 2번 출구 옆 대여소&target=bicycle
703,737,201,107,16446,17411,94,-965,1,0.305194805,오목교역 7번출구 앞,장수공원,http://map.daum.net/?sName=오목교역 7번출구 앞 대여소&eName=장수공원 대여소&target=bicycle
722,746,97,182,4764,5476,-85,-712,1,0.304659498,LG전자베스트샵 신정점,목동2단지 상가,http://map.daum.net/?sName=LG전자베스트샵 신정점 대여소&eName=목동2단지 상가 대여소&target=bicycle
744,746,314,200,5958,6260,114,-302,2,0.221789883,신목동역 2번 출구,목동2단지 상가,http://map.daum.net/?sName=신목동역 2번 출구 대여소&eName=목동2단지 상가 대여소&target=bicycle
2246,2263,76,142,2578,2772,-66,-194,1,0.302752294,서울시 품질시험소 앞,바우뫼문화복지회관,http://map.daum.net/?sName=서울시 품질시험소 앞 대여소&eName=바우뫼문화복지회관 대여소&target=bicycle
2310,2313,73,136,2743,2580,-63,163,1,0.301435407,청담동 맥도날드 옆(위치),금원빌딩 앞,http://map.daum.net/?sName=청담동 맥도날드 옆(위치) 대여소&eName=금원빌딩 앞 대여소&target=bicycle
716,726,72,134,8037,8923,-62,-886,1,0.300970874,신정6동 주민센터 인근,목동3단지 시내버스정류장,http://map.daum.net/?sName=신정6동 주민센터 인근 대여소&eName=목동3단지 시내버스정류장 대여소&target=bicycle
321,387,72,134,5599,4916,-62,683,1,0.300970874,KEB 하나은행 본점 앞,훈련원공원주차장 앞,http://map.daum.net/?sName=KEB 하나은행 본점 앞 대여소&eName=훈련원공원주차장 앞 대여소&target=bicycle
1135,1139,188,121,3790,3474,67,316,1,0.216828479,강서구의회,용문사 버스정류장,http://map.daum.net/?sName=강서구의회 대여소&eName=용문사 버스정류장 대여소&target=bicycle
1011,1027,333,189,10393,10422,144,-29,2,0.275862069,LIGA 아파트 앞,프라자 아파트 앞,http://map.daum.net/?sName=LIGA 아파트 앞 대여소&eName=프라자 아파트 앞 대여소&target=bicycle
1019,1027,104,190,9845,11137,-86,-1292,1,0.292517007,다성이즈빌아파트(호원대 대각선 맞은편),프라자 아파트 앞,http://map.daum.net/?sName=다성이즈빌아파트(호원대 대각선 맞은편) 대여소&eName=프라자 아파트 앞 대여소&target=bicycle
1011,1210,124,197,10393,10422,-73,-29,1,0.22741433,LIGA 아파트 앞,롯데월드타워(잠실역2번출구 쪽),http://map.daum.net/?sName=LIGA 아파트 앞 대여소&eName=롯데월드타워(잠실역2번출구 쪽) 대여소&target=bicycle
2213,2220,178,110,4585,3679,68,906,1,0.236111111,고속터미널역 5번출구 앞,반포본동 주민센터 앞,http://map.daum.net/?sName=고속터미널역 5번출구 앞 대여소&eName=반포본동 주민센터 앞 대여소&target=bicycle
1249,2316,138,75,4142,4436,63,-294,1,0.295774648,아주중학교건너편,삼성역 8번출구,http://map.daum.net/?sName=아주중학교건너편 대여소&eName=삼성역 8번출구 대여소&target=bicycle
2002,2024,170,306,15126,17605,-136,-2479,2,0.285714286,노들역 1번출구,상도역 1번출구,http://map.daum.net/?sName=노들역 1번출구 대여소&eName=상도역 1번출구 대여소&target=bicycle
2002,2013,160,278,15126,17605,-118,-2479,2,0.269406393,노들역 1번출구,장승배기역 5번출구,http://map.daum.net/?sName=노들역 1번출구 대여소&eName=장승배기역 5번출구 대여소&target=bicycle
585,589,1416,771,7791,8154,645,-363,12,0.294924554,성수2가1동 공영주차장 인근,성수역3번출구,http://map.daum.net/?sName=성수2가1동 공영주차장 인근 대여소&eName=성수역3번출구 대여소&target=bicycle
561,589,151,100,6387,6015,51,372,1,0.203187251,서울숲역 2번출구 앞,성수역3번출구,http://map.daum.net/?sName=서울숲역 2번출구 앞 대여소&eName=성수역3번출구 대여소&target=bicycle
1150,1151,122,224,4177,4106,-102,71,2,0.294797688,송정역 1번출구,마곡역1번출구,http://map.daum.net/?sName=송정역 1번출구 대여소&eName=마곡역1번출구 대여소&target=bicycle
259,271,134,246,14567,14790,-112,-223,2,0.294736842,대방역6번출구,샛강생태공원방문자센터 앞,http://map.daum.net/?sName=대방역6번출구 대여소&eName=샛강생태공원방문자센터 앞 대여소&target=bicycle
542,543,78,134,7692,7609,-56,83,1,0.264150943,강변역 4번출구 뒤,구의공원(테크노마트 앞),http://map.daum.net/?sName=강변역 4번출구 뒤 대여소&eName=구의공원(테크노마트 앞) 대여소&target=bicycle
505,543,124,199,14171,13812,-75,359,1,0.232198142,자양사거리 광진아크로텔 앞,구의공원(테크노마트 앞),http://map.daum.net/?sName=자양사거리 광진아크로텔 앞 대여소&eName=구의공원(테크노마트 앞) 대여소&target=bicycle
306,314,116,211,6507,5357,-95,1150,1,0.290519878,광화문역 7번출구 앞,국립현대미술관,http://map.daum.net/?sName=광화문역 7번출구 앞 대여소&eName=국립현대미술관 대여소&target=bicycle
324,370,73,132,5364,5560,-59,-196,1,0.287804878,신세계백화점 본점 앞,시청역(2호선) 9번출구 뒤,http://map.daum.net/?sName=신세계백화점 본점 앞 대여소&eName=시청역(2호선) 9번출구 뒤 대여소&target=bicycle
519,558,159,88,5106,3820,71,1286,1,0.287449393,양지사거리,성동광진 교육지원청 앞,http://map.daum.net/?sName=양지사거리 대여소&eName=성동광진 교육지원청 앞 대여소&target=bicycle
1920,1958,130,72,4195,3349,58,846,1,0.287128713,서울미래초등학교 사거리,강서수도사업소민원센터,http://map.daum.net/?sName=서울미래초등학교 사거리 대여소&eName=강서수도사업소민원센터 대여소&target=bicycle
402,405,157,87,5010,4687,70,323,1,0.286885246,상암월드컵파크 9단지 앞,DMC빌 앞,http://map.daum.net/?sName=상암월드컵파크 9단지 앞 대여소&eName=DMC빌 앞 대여소&target=bicycle
1207,1229,95,171,2964,4304,-76,-1340,1,0.285714286,마천CU우방점 앞,송파체육문화회관 앞,http://map.daum.net/?sName=마천CU우방점 앞 대여소&eName=송파체육문화회관 앞 대여소&target=bicycle
1637,1651,131,73,10846,10150,58,696,1,0.284313725,KT 노원점 건물 앞,맥도날드 상계점 앞,http://map.daum.net/?sName=KT 노원점 건물 앞 대여소&eName=맥도날드 상계점 앞 대여소&target=bicycle
347,372,99,152,8262,7773,-53,489,1,0.211155378,동대문역사문화공원역 9번출구 앞,약수역 3번출구 뒤,http://map.daum.net/?sName=동대문역사문화공원역 9번출구 앞 대여소&eName=약수역 3번출구 뒤 대여소&target=bicycle
1128,739,162,95,2844,2517,67,327,1,0.260700389,화곡역 6번출구,신월사거리,http://map.daum.net/?sName=화곡역 6번출구 대여소&eName=신월사거리 대여소&target=bicycle
1128,714,116,179,2844,2517,-63,327,1,0.213559322,화곡역 6번출구,한국SGI 양천문화회관 앞,http://map.daum.net/?sName=화곡역 6번출구 대여소&eName=한국SGI 양천문화회관 앞 대여소&target=bicycle
1333,647,90,159,4398,5241,-69,-843,1,0.277108434,석관초등학교 앞,신이문역 1번출구,http://map.daum.net/?sName=석관초등학교 앞 대여소&eName=신이문역 1번출구 대여소&target=bicycle
1961,2141,98,173,9771,9407,-75,364,1,0.276752768,신도림테크노근린공원,미림여고입구 교차로,http://map.daum.net/?sName=신도림테크노근린공원 대여소&eName=미림여고입구 교차로 대여소&target=bicycle
2279,2297,134,236,4276,4077,-102,199,2,0.275675676,교대역 5번출구뒤,남부터미널역 1번출구,http://map.daum.net/?sName=교대역 5번출구뒤 대여소&eName=남부터미널역 1번출구 대여소&target=bicycle
304,315,147,84,5979,5598,63,381,1,0.272727273,광화문역 2번출구 앞,신한은행 안국역지점 옆,http://map.daum.net/?sName=광화문역 2번출구 앞 대여소&eName=신한은행 안국역지점 옆 대여소&target=bicycle
904,954,243,425,2820,2960,-182,-140,3,0.27245509,은평뉴타운 푸르지오,은평뉴타운구파발9단지,http://map.daum.net/?sName=은평뉴타운 푸르지오 대여소&eName=은평뉴타운구파발9단지 대여소&target=bicycle
1616,1665,106,185,9055,9636,-79,-581,1,0.271477663,하계2동 공항버스정류장 옆,양지근린공원앞,http://map.daum.net/?sName=하계2동 공항버스정류장 옆 대여소&eName=양지근린공원앞 대여소&target=bicycle
3502,539,141,81,2989,3367,60,-378,1,0.27027027,중곡역 1번출구,군자교교차로,http://map.daum.net/?sName=중곡역 1번출구 대여소&eName=군자교교차로 대여소&target=bicycle
1625,1654,100,174,11449,11180,-74,269,1,0.270072993,상계역(4번출구),당고개입구 오거리,http://map.daum.net/?sName=상계역(4번출구) 대여소&eName=당고개입구 오거리 대여소&target=bicycle
1625,1659,241,154,11449,11180,87,269,1,0.220253165,상계역(4번출구),중계동 을지중학교,http://map.daum.net/?sName=상계역(4번출구) 대여소&eName=중계동 을지중학교 대여소&target=bicycle
1117,1159,167,97,6916,7260,70,-344,1,0.265151515,스타벅스앞,서서울모터리움앞,http://map.daum.net/?sName=스타벅스앞 대여소&eName=서서울모터리움앞 대여소&target=bicycle
1153,1159,192,301,11596,12171,-109,-575,2,0.221095335,발산역 2번출구,서서울모터리움앞,http://map.daum.net/?sName=발산역 2번출구 대여소&eName=서서울모터리움앞 대여소&target=bicycle
1518,1535,86,148,2133,2096,-62,37,1,0.264957265,SK telecom(수유직영점) 앞,효성인텔리안 앞,http://map.daum.net/?sName=SK telecom(수유직영점) 앞 대여소&eName=효성인텔리안 앞 대여소&target=bicycle
1515,1535,96,150,1952,2035,-54,-83,1,0.219512195,송천동 주민센터,효성인텔리안 앞,http://map.daum.net/?sName=송천동 주민센터 대여소&eName=효성인텔리안 앞 대여소&target=bicycle
120,122,184,121,3107,3243,63,-136,1,0.206557377,신수동 사거리,신성기사식당 앞,http://map.daum.net/?sName=신수동 사거리 대여소&eName=신성기사식당 앞 대여소&target=bicycle
257,279,130,199,8039,11421,-69,-3382,1,0.209726444,신길삼거리(우리은행),영등포 푸르지오 아파트,http://map.daum.net/?sName=신길삼거리(우리은행) 대여소&eName=영등포 푸르지오 아파트 대여소&target=bicycle
235,279,129,77,2774,3094,52,-320,1,0.252427184,신길동 우리은행 옆,영등포 푸르지오 아파트,http://map.daum.net/?sName=신길동 우리은행 옆 대여소&eName=영등포 푸르지오 아파트 대여소&target=bicycle
1530,1539,176,103,4520,4644,73,-124,1,0.261648746,광산사거리,4.19민주묘지역,http://map.daum.net/?sName=광산사거리 대여소&eName=4.19민주묘지역 대여소&target=bicycle
1952,1953,365,622,2346,2847,-257,-501,5,0.260385005,천왕연지타운2단지 앞,천왕역 4번출구 뒤,http://map.daum.net/?sName=천왕연지타운2단지 앞 대여소&eName=천왕역 4번출구 뒤 대여소&target=bicycle
1952,1977,102,168,2346,2847,-66,-501,1,0.244444444,천왕연지타운2단지 앞,천왕역 1번 출입구 앞,http://map.daum.net/?sName=천왕연지타운2단지 앞 대여소&eName=천왕역 1번 출입구 앞 대여소&target=bicycle
2355,2369,147,250,6178,6135,-103,43,2,0.259445844,삼성역 5~6번 출구 사이,KT선릉타워,http://map.daum.net/?sName=삼성역 5~6번 출구 사이 대여소&eName=KT선릉타워 대여소&target=bicycle
2322,2369,87,145,2739,2581,-58,158,1,0.25,삼성역 3번 출구,KT선릉타워,http://map.daum.net/?sName=삼성역 3번 출구 대여소&eName=KT선릉타워 대여소&target=bicycle
3517,3518,94,150,4095,5208,-56,-1113,1,0.229508197,용마사거리,군자역 7번출구뒤,http://map.daum.net/?sName=용마사거리 대여소&eName=군자역 7번출구뒤 대여소&target=bicycle
236,265,123,209,5549,5562,-86,-13,1,0.259036145,문래동자이아파트 앞,영등포유통상가 사거리,http://map.daum.net/?sName=문래동자이아파트 앞 대여소&eName=영등포유통상가 사거리 대여소&target=bicycle
244,265,158,95,10470,11241,63,-771,1,0.249011858,영등포삼환아파트 앞,영등포유통상가 사거리,http://map.daum.net/?sName=영등포삼환아파트 앞 대여소&eName=영등포유통상가 사거리 대여소&target=bicycle
550,609,88,139,4022,4113,-51,-91,1,0.224669604,서울시설공단 앞,제기2교,http://map.daum.net/?sName=서울시설공단 앞 대여소&eName=제기2교 대여소&target=bicycle
2321,2323,96,163,3766,3717,-67,49,1,0.258687259,학여울역 사거리,주식회사 오뚜기 정문 앞,http://map.daum.net/?sName=학여울역 사거리 대여소&eName=주식회사 오뚜기 정문 앞 대여소&target=bicycle
2321,2342,175,111,3766,3717,64,49,1,0.223776224,학여울역 사거리,대청역 1번출구  뒤,http://map.daum.net/?sName=학여울역 사거리 대여소&eName=대청역 1번출구  뒤 대여소&target=bicycle
2337,2342,329,210,3204,2987,119,217,2,0.220779221,대모산입구역 2번출구 앞,대청역 1번출구  뒤,http://map.daum.net/?sName=대모산입구역 2번출구 앞 대여소&eName=대청역 1번출구  뒤 대여소&target=bicycle
1620,1667,134,79,3909,4006,55,-97,1,0.258215962,중계동 노원구민체육센터 옆(중1-2),중계중학교,http://map.daum.net/?sName=중계동 노원구민체육센터 옆(중1-2) 대여소&eName=중계중학교 대여소&target=bicycle
1012,1019,156,92,3670,3136,64,534,1,0.258064516,서울 상운차량,다성이즈빌아파트(호원대 대각선 맞은편),http://map.daum.net/?sName=서울 상운차량 대여소&eName=다성이즈빌아파트(호원대 대각선 맞은편) 대여소&target=bicycle
419,422,81,137,13162,11585,-56,1577,1,0.256880734,홈플러스 앞,문화비축기지,http://map.daum.net/?sName=홈플러스 앞 대여소&eName=문화비축기지 대여소&target=bicycle
419,915,197,118,13162,11585,79,1577,1,0.250793651,홈플러스 앞,증산역 4번출구,http://map.daum.net/?sName=홈플러스 앞 대여소&eName=증산역 4번출구 대여소&target=bicycle
1227,1244,148,98,3523,3911,50,-388,1,0.203252033,거여역 8번출구 뒤,문정 법조단지8,http://map.daum.net/?sName=거여역 8번출구 뒤 대여소&eName=문정 법조단지8 대여소&target=bicycle
1822,1827,138,82,2016,2348,56,-332,1,0.254545455,서울 시흥동우체국 앞,독산보도육교 앞 자전거 보관소,http://map.daum.net/?sName=서울 시흥동우체국 앞 대여소&eName=독산보도육교 앞 자전거 보관소 대여소&target=bicycle
1102,1113,141,84,3695,3886,57,-191,1,0.253333333,방화사거리 마을버스 버스정류장,서남환경공원 버스정류장,http://map.daum.net/?sName=방화사거리 마을버스 버스정류장 대여소&eName=서남환경공원 버스정류장 대여소&target=bicycle
726,747,170,285,3804,4054,-115,-250,2,0.252747253,목동3단지 시내버스정류장,목동3단지 상가,http://map.daum.net/?sName=목동3단지 시내버스정류장 대여소&eName=목동3단지 상가 대여소&target=bicycle
540,562,177,108,11140,11235,69,-95,1,0.242105263,군자역 7번출구 베스트샵 앞,군자지하보도 앞,http://map.daum.net/?sName=군자역 7번출구 베스트샵 앞 대여소&eName=군자지하보도 앞 대여소&target=bicycle
933,947,110,184,4767,5565,-74,-798,1,0.25170068,LG서비스 역촌점,연신내 선일하이츠빌 정류소,http://map.daum.net/?sName=LG서비스 역촌점 대여소&eName=연신내 선일하이츠빌 정류소 대여소&target=bicycle
2231,2237,127,212,9434,9496,-85,-62,1,0.250737463,삼성타운(삼성생명) A동 맞은편,서울남부터미널 대합실 입구,http://map.daum.net/?sName=삼성타운(삼성생명) A동 맞은편 대여소&eName=서울남부터미널 대합실 입구 대여소&target=bicycle
1152,1161,148,89,4517,4693,59,-176,1,0.248945148,마곡역교차로,강서면허시험장앞,http://map.daum.net/?sName=마곡역교차로 대여소&eName=강서면허시험장앞 대여소&target=bicycle
145,198,86,143,6277,6626,-57,-349,1,0.248908297,공덕역 5번출구,충정2교,http://map.daum.net/?sName=공덕역 5번출구 대여소&eName=충정2교 대여소&target=bicycle
614,630,180,299,10011,9890,-119,121,2,0.248434238,용두동 사거리,동대문구 보건소,http://map.daum.net/?sName=용두동 사거리 대여소&eName=동대문구 보건소 대여소&target=bicycle
1140,1141,401,255,3624,4089,146,-465,2,0.222560976,목동사거리 버스정류장,곰달래 문화복지센터 1-1,http://map.daum.net/?sName=목동사거리 버스정류장 대여소&eName=곰달래 문화복지센터 1-1 대여소&target=bicycle
1666,1673,245,148,3706,3521,97,185,1,0.246819338,노원소방서인근,노원역 5번출구,http://map.daum.net/?sName=노원소방서인근 대여소&eName=노원역 5번출구 대여소&target=bicycle
240,277,143,87,7187,6598,56,589,1,0.243478261,문래역 4번출구 앞,영등포뉴타운지하상가 2번게이트,http://map.daum.net/?sName=문래역 4번출구 앞 대여소&eName=영등포뉴타운지하상가 2번게이트 대여소&target=bicycle
1623,1650,184,112,8075,8067,72,8,1,0.243243243,노원 구민회관,중계근린공원내,http://map.daum.net/?sName=노원 구민회관 대여소&eName=중계근린공원내 대여소&target=bicycle
1636,1650,263,166,8267,8017,97,250,1,0.226107226,백병원 사거리 농협은행 앞,중계근린공원내,http://map.daum.net/?sName=백병원 사거리 농협은행 앞 대여소&eName=중계근린공원내 대여소&target=bicycle
1151,1153,169,103,3597,3151,66,446,1,0.242647059,마곡역1번출구,발산역 2번출구,http://map.daum.net/?sName=마곡역1번출구 대여소&eName=발산역 2번출구 대여소&target=bicycle
1129,1153,109,170,3791,3603,-61,188,1,0.218637993,화곡역 1번 출구 앞,발산역 2번출구,http://map.daum.net/?sName=화곡역 1번 출구 앞 대여소&eName=발산역 2번출구 대여소&target=bicycle
1271,1277,179,110,5309,5344,69,-35,1,0.238754325,송파도서관,오금동 송파 참병원,http://map.daum.net/?sName=송파도서관 대여소&eName=오금동 송파 참병원 대여소&target=bicycle
255,278,154,249,3466,4121,-95,-655,1,0.23573201,도림4거리,쌍용플레티넘오피스텔,http://map.daum.net/?sName=도림4거리 대여소&eName=쌍용플레티넘오피스텔 대여소&target=bicycle
361,586,88,142,10851,11440,-54,-589,1,0.234782609,동묘앞역 1번출구 뒤,마장동 주민센터,http://map.daum.net/?sName=동묘앞역 1번출구 뒤 대여소&eName=마장동 주민센터 대여소&target=bicycle
807,820,258,160,3700,3547,98,153,1,0.234449761,서울역 12번 출구 앞,청파동입구 교차로,http://map.daum.net/?sName=서울역 12번 출구 앞 대여소&eName=청파동입구 교차로 대여소&target=bicycle
1323,1354,121,195,3817,4388,-74,-571,1,0.234177215,월곡역 입구 육교 밑,고려대학교 2번출구,http://map.daum.net/?sName=월곡역 입구 육교 밑 대여소&eName=고려대학교 2번출구 대여소&target=bicycle
1808,1851,689,428,2547,2098,261,449,5,0.233661594,에이스하이엔드타워8차 앞,가산디지털단지 7번출구,http://map.daum.net/?sName=에이스하이엔드타워8차 앞 대여소&eName=가산디지털단지 7번출구 대여소&target=bicycle
923,927,198,123,2380,2289,75,91,1,0.23364486,국민은행 연서지점,연신내역 3번출구 인근,http://map.daum.net/?sName=국민은행 연서지점 대여소&eName=연신내역 3번출구 인근 대여소&target=bicycle
1960,1985,354,220,4700,4448,134,252,2,0.233449477,화광신문사 앞,구로도서관,http://map.daum.net/?sName=화광신문사 앞 대여소&eName=구로도서관 대여소&target=bicycle
1834,1904,177,110,4940,4973,67,-33,1,0.233449477,월드메르디앙 벤처센터 2차,도림천역 1번 출구 앞,http://map.daum.net/?sName=월드메르디앙 벤처센터 2차 대여소&eName=도림천역 1번 출구 앞 대여소&target=bicycle
1027,1048,93,147,2484,2711,-54,-227,1,0.225,프라자 아파트 앞,동부기업(둔촌동),http://map.daum.net/?sName=프라자 아파트 앞 대여소&eName=동부기업(둔촌동) 대여소&target=bicycle
505,552,106,159,14171,13812,-53,359,1,0.2,자양사거리 광진아크로텔 앞,대림아크로리버 앞,http://map.daum.net/?sName=자양사거리 광진아크로텔 앞 대여소&eName=대림아크로리버 앞 대여소&target=bicycle
3514,378,101,162,6762,6297,-61,465,1,0.231939163,왕십리교회옆,청계7가 사거리,http://map.daum.net/?sName=왕십리교회옆 대여소&eName=청계7가 사거리 대여소&target=bicycle
3514,613,228,148,6762,6297,80,465,1,0.212765957,왕십리교회옆,신설동역 10번출구 앞,http://map.daum.net/?sName=왕십리교회옆 대여소&eName=신설동역 10번출구 앞 대여소&target=bicycle
1501,1503,203,127,4666,4733,76,-67,1,0.23030303,"미아역 3번,4번 출구 사이",이디야 커피 수유역점 앞,"http://map.daum.net/?sName=미아역 3번,4번 출구 사이 대여소&eName=이디야 커피 수유역점 앞 대여소&target=bicycle"
2370,2372,159,100,4035,3509,59,526,1,0.227799228,한티역 3번출구,대치역 사거리,http://map.daum.net/?sName=한티역 3번출구 대여소&eName=대치역 사거리 대여소&target=bicycle
2342,2372,125,194,5479,6426,-69,-947,1,0.21630094,대청역 1번출구  뒤,대치역 사거리,http://map.daum.net/?sName=대청역 1번출구  뒤 대여소&eName=대치역 사거리 대여소&target=bicycle
1519,1715,169,108,2078,2182,61,-104,1,0.220216606,세븐일레븐 수유장미원점 앞,서울특별시교육청도봉도서관,http://map.daum.net/?sName=세븐일레븐 수유장미원점 앞 대여소&eName=서울특별시교육청도봉도서관 대여소&target=bicycle
1839,1841,204,319,3161,2660,-115,501,2,0.219885277,수출의 다리 아래,가산동 주민센터,http://map.daum.net/?sName=수출의 다리 아래 대여소&eName=가산동 주민센터 대여소&target=bicycle
1933,1965,112,173,3317,4189,-61,-872,1,0.214035088,개봉푸르지오아파트 상가,삼환로즈빌아파트 105동 옆,http://map.daum.net/?sName=개봉푸르지오아파트 상가 대여소&eName=삼환로즈빌아파트 105동 옆 대여소&target=bicycle
1933,1964,120,181,3317,4189,-61,-872,1,0.202657807,개봉푸르지오아파트 상가,원메디타운 앞,http://map.daum.net/?sName=개봉푸르지오아파트 상가 대여소&eName=원메디타운 앞 대여소&target=bicycle
1115,1121,162,105,4637,4590,57,47,1,0.213483146,등촌역 1번출구옆,가양레포츠센터앞,http://map.daum.net/?sName=등촌역 1번출구옆 대여소&eName=가양레포츠센터앞 대여소&target=bicycle
1328,1333,236,153,8309,9246,83,-937,1,0.213367609,월곡역 3번출구,석관초등학교 앞,http://map.daum.net/?sName=월곡역 3번출구 대여소&eName=석관초등학교 앞 대여소&target=bicycle
1953,1981,219,142,2269,2011,77,258,1,0.213296399,천왕역 4번출구 뒤,천왕이펜하우스5단지 앞,http://map.daum.net/?sName=천왕역 4번출구 뒤 대여소&eName=천왕이펜하우스5단지 앞 대여소&target=bicycle
1112,1125,159,104,10148,10803,55,-655,1,0.209125475,마곡엠밸리4단지 정문,명덕고교입구(영종빌딩),http://map.daum.net/?sName=마곡엠밸리4단지 정문 대여소&eName=명덕고교입구(영종빌딩) 대여소&target=bicycle
152,182,310,475,24551,28131,-165,-3580,3,0.210191083,마포구민체육센터 앞,망원2빗물펌프장 앞,http://map.daum.net/?sName=마포구민체육센터 앞 대여소&eName=망원2빗물펌프장 앞 대여소&target=bicycle
1634,1653,222,146,3295,3291,76,4,1,0.206521739,당고개공원 대여소,노원역1번출구,http://map.daum.net/?sName=당고개공원 대여소 대여소&eName=노원역1번출구 대여소&target=bicycle
1420,1431,104,158,1981,2230,-54,-249,1,0.20610687,신내어울공원 앞,중랑구청 사거리,http://map.daum.net/?sName=신내어울공원 앞 대여소&eName=중랑구청 사거리 대여소&target=bicycle
2327,2331,104,158,6110,6125,-54,-15,1,0.20610687,뱅뱅사거리 랜드마크타워 앞,동영문화센터앞,http://map.daum.net/?sName=뱅뱅사거리 랜드마크타워 앞 대여소&eName=동영문화센터앞 대여소&target=bicycle
2327,2333,343,521,6110,6125,-178,-15,3,0.206018519,뱅뱅사거리 랜드마크타워 앞,양재역 3번출구 주변,http://map.daum.net/?sName=뱅뱅사거리 랜드마크타워 앞 대여소&eName=양재역 3번출구 주변 대여소&target=bicycle
1267,1278,174,115,6161,5703,59,458,1,0.204152249,올림픽공원 남2문 앞,송파구청 교차로,http://map.daum.net/?sName=올림픽공원 남2문 앞 대여소&eName=송파구청 교차로 대여소&target=bicycle
